MESE,ANNO,TIPO SOGGETTO,TIPOLOGIA CERTIFICATO,BOLLO,ESENTI DA BOLLO,TOTALE
11,2021,AIRE,CITTADINANZA,296,191,487
11,2021,AIRE,CONTESTUALE,914,814,1728
11,2021,AIRE,ESISTENZA IN VITA,3,0,3
11,2021,AIRE,MATRIMONIO,222,270,492
11,2021,AIRE,NASCITA,448,380,828
11,2021,AIRE,RESIDENZA,648,695,1343
11,2021,AIRE,STATO CIVILE,11,4,15
11,2021,AIRE,STATO FAMIGLIA,364,410,774
11,2021,AIRE,STATO FAMIGLIA CON RAPPORTI PARENTELA,2,0,2
11,2021,AIRE,STATO FAMIGLIA E STATO CIVILE,4,2,6
11,2021,AIRE,STATO LIBERO,3,1,4
11,2021,AIRE,UNIONE CIVILE ,0,4,4
11,2021,Residenti,CITTADINANZA,4969,3810,8779
11,2021,Residenti,CONTESTUALE,52350,54329,106679
11,2021,Residenti,CONTRATTO CONVIVENZA,24,11,35
11,2021,Residenti,ESISTENZA IN VITA,4463,4939,9402
11,2021,Residenti,MATRIMONIO,14117,21304,35421
11,2021,Residenti,NASCITA,21975,29830,51805
11,2021,Residenti,RESIDENZA,40061,51711,91772
11,2021,Residenti,RESIDENZA IN CONVIVENZA,47,63,110
11,2021,Residenti,STATO CIVILE,11071,11853,22924
11,2021,Residenti,STATO FAMIGLIA,35602,48855,84457
11,2021,Residenti,STATO FAMIGLIA CON RAPPORTI PARENTELA,12198,15357,27555
11,2021,Residenti,STATO FAMIGLIA E STATO CIVILE,11155,13996,25151
11,2021,Residenti,STATO LIBERO,5464,3732,9196
11,2021,Residenti,UNIONE CIVILE ,178,158,336
12,2021,AIRE,CITTADINANZA,155,104,259
12,2021,AIRE,CONTESTUALE,451,306,757
12,2021,AIRE,ESISTENZA IN VITA,4,0,4
12,2021,AIRE,MATRIMONIO,177,140,317
12,2021,AIRE,NASCITA,308,242,550
12,2021,AIRE,RESIDENZA,426,401,827
12,2021,AIRE,STATO CIVILE,6,2,8
12,2021,AIRE,STATO FAMIGLIA,230,216,446
12,2021,AIRE,STATO FAMIGLIA CON RAPPORTI PARENTELA,0,2,2
12,2021,AIRE,STATO FAMIGLIA E STATO CIVILE,4,2,6
12,2021,AIRE,STATO LIBERO,2,0,2
12,2021,AIRE,UNIONE CIVILE ,2,3,5
12,2021,Residenti,CITTADINANZA,3230,1403,4633
12,2021,Residenti,CONTESTUALE,35868,30902,66770
12,2021,Residenti,CONTRATTO CONVIVENZA,7,6,13
12,2021,Residenti,ESISTENZA IN VITA,2617,2024,4641
12,2021,Residenti,MATRIMONIO,8807,9431,18238
12,2021,Residenti,NASCITA,12039,11046,23085
12,2021,Residenti,RESIDENZA,31695,35671,67366
12,2021,Residenti,RESIDENZA IN CONVIVENZA,37,30,67
12,2021,Residenti,STATO CIVILE,8767,7205,15972
12,2021,Residenti,STATO FAMIGLIA,29053,33580,62633
12,2021,Residenti,STATO FAMIGLIA CON RAPPORTI PARENTELA,7595,7139,14734
12,2021,Residenti,STATO FAMIGLIA E STATO CIVILE,7126,6229,13355
12,2021,Residenti,STATO LIBERO,5044,3008,8052
12,2021,Residenti,UNIONE CIVILE ,37,39,76
1,2022,AIRE,CITTADINANZA,150,88,238
1,2022,AIRE,CONTESTUALE,375,316,691
1,2022,AIRE,ESISTENZA IN VITA,0,1,1
1,2022,AIRE,MATRIMONIO,112,132,244
1,2022,AIRE,NASCITA,319,279,598
1,2022,AIRE,RESIDENZA,316,336,652
1,2022,AIRE,STATO CIVILE,6,6,12
1,2022,AIRE,STATO FAMIGLIA,188,214,402
1,2022,AIRE,STATO FAMIGLIA CON RAPPORTI PARENTELA,2,2,4
1,2022,AIRE,STATO FAMIGLIA E STATO CIVILE,1,1,2
1,2022,AIRE,STATO LIBERO,5,2,7
1,2022,AIRE,UNIONE CIVILE ,1,2,3
1,2022,Residenti,CITTADINANZA,1749,1567,3316
1,2022,Residenti,CONTESTUALE,39591,39442,79033
1,2022,Residenti,CONTRATTO CONVIVENZA,19,9,28
1,2022,Residenti,ESISTENZA IN VITA,1682,2247,3929
1,2022,Residenti,MATRIMONIO,8089,10956,19045
1,2022,Residenti,NASCITA,11235,12614,23849
1,2022,Residenti,RESIDENZA,36055,47632,83687
1,2022,Residenti,RESIDENZA IN CONVIVENZA,46,41,87
1,2022,Residenti,STATO CIVILE,8081,8846,16927
1,2022,Residenti,STATO FAMIGLIA,47635,61271,108906
1,2022,Residenti,STATO FAMIGLIA CON RAPPORTI PARENTELA,8204,10508,18712
1,2022,Residenti,STATO FAMIGLIA E STATO CIVILE,7430,8968,16398
1,2022,Residenti,STATO LIBERO,5083,3633,8716
1,2022,Residenti,UNIONE CIVILE ,35,40,75
2,2022,AIRE,CITTADINANZA,102,76,178
2,2022,AIRE,CONTESTUALE,330,330,660
2,2022,AIRE,ESISTENZA IN VITA,1,1,2
2,2022,AIRE,MATRIMONIO,105,135,240
2,2022,AIRE,NASCITA,302,249,551
2,2022,AIRE,RESIDENZA,319,339,658
2,2022,AIRE,STATO CIVILE,1,7,8
2,2022,AIRE,STATO FAMIGLIA,187,189,376
2,2022,AIRE,STATO FAMIGLIA CON RAPPORTI PARENTELA,0,5,5
2,2022,AIRE,STATO FAMIGLIA E STATO CIVILE,2,3,5
2,2022,AIRE,STATO LIBERO,0,1,1
2,2022,AIRE,UNIONE CIVILE ,4,2,6
2,2022,Residenti,CITTADINANZA,1771,1441,3212
2,2022,Residenti,CONTESTUALE,41687,40151,81838
2,2022,Residenti,CONTRATTO CONVIVENZA,11,9,20
2,2022,Residenti,ESISTENZA IN VITA,1325,1682,3007
2,2022,Residenti,MATRIMONIO,8486,11214,19700
2,2022,Residenti,NASCITA,10201,11624,21825
2,2022,Residenti,RESIDENZA,32798,42286,75084
2,2022,Residenti,RESIDENZA IN CONVIVENZA,45,41,86
2,2022,Residenti,STATO CIVILE,8717,9664,18381
2,2022,Residenti,STATO FAMIGLIA,37440,48930,86370
2,2022,Residenti,STATO FAMIGLIA CON RAPPORTI PARENTELA,6519,8468,14987
2,2022,Residenti,STATO FAMIGLIA E STATO CIVILE,6630,7883,14513
2,2022,Residenti,STATO LIBERO,5879,4486,10365
2,2022,Residenti,UNIONE CIVILE ,42,39,81
3,2022,AIRE,CITTADINANZA,98,84,182
3,2022,AIRE,CONTESTUALE,345,329,674
3,2022,AIRE,ESISTENZA IN VITA,0,1,1
3,2022,AIRE,MATRIMONIO,99,127,226
3,2022,AIRE,NASCITA,291,288,579
3,2022,AIRE,RESIDENZA,267,335,602
3,2022,AIRE,STATO CIVILE,7,13,20
3,2022,AIRE,STATO FAMIGLIA,185,205,390
3,2022,AIRE,STATO FAMIGLIA CON RAPPORTI PARENTELA,5,0,5
3,2022,AIRE,STATO FAMIGLIA E STATO CIVILE,5,4,9
3,2022,AIRE,STATO LIBERO,4,4,8
3,2022,AIRE,UNIONE CIVILE ,7,1,8
3,2022,Residenti,CITTADINANZA,2088,1405,3493
3,2022,Residenti,CONTESTUALE,46115,42849,88964
3,2022,Residenti,CONTRATTO CONVIVENZA,7,9,16
3,2022,Residenti,ESISTENZA IN VITA,1397,1508,2905
3,2022,Residenti,MATRIMONIO,9399,12218,21617
3,2022,Residenti,NASCITA,11122,12276,23398
3,2022,Residenti,RESIDENZA,37390,46449,83839
3,2022,Residenti,RESIDENZA IN CONVIVENZA,57,44,101
3,2022,Residenti,STATO CIVILE,9846,10096,19942
3,2022,Residenti,STATO FAMIGLIA,36216,46049,82265
3,2022,Residenti,STATO FAMIGLIA CON RAPPORTI PARENTELA,6492,8215,14707
3,2022,Residenti,STATO FAMIGLIA E STATO CIVILE,6729,7662,14391
3,2022,Residenti,STATO LIBERO,6607,5062,11669
3,2022,Residenti,UNIONE CIVILE ,40,48,88
4,2022,AIRE,CITTADINANZA,96,87,183
4,2022,AIRE,CONTESTUALE,346,283,629
4,2022,AIRE,ESISTENZA IN VITA,1,1,2
4,2022,AIRE,MATRIMONIO,71,120,191
4,2022,AIRE,NASCITA,273,228,501
4,2022,AIRE,RESIDENZA,341,448,789
4,2022,AIRE,STATO CIVILE,4,4,8
4,2022,AIRE,STATO FAMIGLIA,160,204,364
4,2022,AIRE,STATO FAMIGLIA CON RAPPORTI PARENTELA,0,6,6
4,2022,AIRE,STATO FAMIGLIA E STATO CIVILE,3,2,5
4,2022,AIRE,STATO LIBERO,1,4,5
4,2022,AIRE,UNIONE CIVILE ,0,2,2
4,2022,Residenti,CITTADINANZA,1641,1203,2844
4,2022,Residenti,CONTESTUALE,36742,34719,71461
4,2022,Residenti,CONTRATTO CONVIVENZA,9,4,13
4,2022,Residenti,ESISTENZA IN VITA,1051,1285,2336
4,2022,Residenti,MATRIMONIO,7535,9512,17047
4,2022,Residenti,NASCITA,9156,9971,19127
4,2022,Residenti,RESIDENZA,32053,39917,71970
4,2022,Residenti,RESIDENZA IN CONVIVENZA,47,45,92
4,2022,Residenti,STATO CIVILE,7781,8349,16130
4,2022,Residenti,STATO FAMIGLIA,27785,34674,62459
4,2022,Residenti,STATO FAMIGLIA CON RAPPORTI PARENTELA,5304,6369,11673
4,2022,Residenti,STATO FAMIGLIA E STATO CIVILE,5328,5971,11299
4,2022,Residenti,STATO LIBERO,5490,4268,9758
4,2022,Residenti,UNIONE CIVILE ,51,36,87
5,2022,AIRE,CITTADINANZA,112,86,198
5,2022,AIRE,CONTESTUALE,396,321,717
5,2022,AIRE,MATRIMONIO,116,138,254
5,2022,AIRE,NASCITA,329,244,573
5,2022,AIRE,RESIDENZA,358,416,774
5,2022,AIRE,STATO CIVILE,8,10,18
5,2022,AIRE,STATO FAMIGLIA,188,189,377
5,2022,AIRE,STATO FAMIGLIA CON RAPPORTI PARENTELA,1,5,6
5,2022,AIRE,STATO FAMIGLIA E STATO CIVILE,3,2,5
5,2022,AIRE,STATO LIBERO,4,3,7
5,2022,AIRE,UNIONE CIVILE ,0,1,1
5,2022,Residenti,CITTADINANZA,1764,1366,3130
5,2022,Residenti,CONTESTUALE,40276,38765,79041
5,2022,Residenti,CONTRATTO CONVIVENZA,19,7,26
5,2022,Residenti,ESISTENZA IN VITA,1171,1377,2548
5,2022,Residenti,MATRIMONIO,8364,11037,19401
5,2022,Residenti,NASCITA,9861,11378,21239
5,2022,Residenti,RESIDENZA,38606,46676,85282
5,2022,Residenti,RESIDENZA IN CONVIVENZA,43,51,94
5,2022,Residenti,STATO CIVILE,9319,9929,19248
5,2022,Residenti,STATO FAMIGLIA,33254,41447,74701
5,2022,Residenti,STATO FAMIGLIA CON RAPPORTI PARENTELA,5996,7389,13385
5,2022,Residenti,STATO FAMIGLIA E STATO CIVILE,6023,6937,12960
5,2022,Residenti,STATO LIBERO,6297,4990,11287
5,2022,Residenti,UNIONE CIVILE ,38,33,71
6,2022,AIRE,CITTADINANZA,123,82,205
6,2022,AIRE,CONTESTUALE,320,257,577
6,2022,AIRE,MATRIMONIO,85,101,186
6,2022,AIRE,NASCITA,285,226,511
6,2022,AIRE,RESIDENZA,291,380,671
6,2022,AIRE,STATO CIVILE,6,6,12
6,2022,AIRE,STATO FAMIGLIA,175,209,384
6,2022,AIRE,STATO FAMIGLIA CON RAPPORTI PARENTELA,2,5,7
6,2022,AIRE,STATO FAMIGLIA E STATO CIVILE,2,1,3
6,2022,AIRE,STATO LIBERO,4,2,6
6,2022,AIRE,UNIONE CIVILE ,1,0,1
6,2022,Residenti,CITTADINANZA,1799,1390,3189
6,2022,Residenti,CONTESTUALE,36978,37025,74003
6,2022,Residenti,CONTRATTO CONVIVENZA,17,6,23
6,2022,Residenti,ESISTENZA IN VITA,1081,1377,2458
6,2022,Residenti,MATRIMONIO,8433,10564,18997
6,2022,Residenti,NASCITA,9160,10058,19218
6,2022,Residenti,RESIDENZA,35259,43638,78897
6,2022,Residenti,RESIDENZA IN CONVIVENZA,39,44,83
6,2022,Residenti,STATO CIVILE,8926,9558,18484
6,2022,Residenti,STATO FAMIGLIA,30459,38075,68534
6,2022,Residenti,STATO FAMIGLIA CON RAPPORTI PARENTELA,5608,6725,12333
6,2022,Residenti,STATO FAMIGLIA E STATO CIVILE,5334,6399,11733
6,2022,Residenti,STATO LIBERO,5698,4747,10445
6,2022,Residenti,UNIONE CIVILE ,41,40,81
7,2022,AIRE,CITTADINANZA,94,76,170
7,2022,AIRE,CONTESTUALE,300,260,560
7,2022,AIRE,ESISTENZA IN VITA,2,0,2
7,2022,AIRE,MATRIMONIO,109,121,230
7,2022,AIRE,NASCITA,264,223,487
7,2022,AIRE,RESIDENZA,320,366,686
7,2022,AIRE,STATO CIVILE,6,6,12
7,2022,AIRE,STATO FAMIGLIA,182,188,370
7,2022,AIRE,STATO FAMIGLIA CON RAPPORTI PARENTELA,1,1,2
7,2022,AIRE,STATO FAMIGLIA E STATO CIVILE,1,2,3
7,2022,AIRE,STATO LIBERO,1,0,1
7,2022,AIRE,UNIONE CIVILE ,2,0,2
7,2022,Residenti,CITTADINANZA,1550,1187,2737
7,2022,Residenti,CONTESTUALE,32003,44439,76442
7,2022,Residenti,CONTRATTO CONVIVENZA,15,16,31
7,2022,Residenti,ESISTENZA IN VITA,1043,1299,2342
7,2022,Residenti,MATRIMONIO,8067,9857,17924
7,2022,Residenti,NASCITA,8593,9659,18252
7,2022,Residenti,RESIDENZA,32577,40595,73172
7,2022,Residenti,RESIDENZA IN CONVIVENZA,40,29,69
7,2022,Residenti,STATO CIVILE,7906,8465,16371
7,2022,Residenti,STATO FAMIGLIA,27235,36979,64214
7,2022,Residenti,STATO FAMIGLIA CON RAPPORTI PARENTELA,5205,6557,11762
7,2022,Residenti,STATO FAMIGLIA E STATO CIVILE,4966,5553,10519
7,2022,Residenti,STATO LIBERO,4875,4117,8992
7,2022,Residenti,UNIONE CIVILE ,52,50,102
8,2022,AIRE,CITTADINANZA,104,69,173
8,2022,AIRE,CONTESTUALE,331,271,602
8,2022,AIRE,ESISTENZA IN VITA,2,0,2
8,2022,AIRE,MATRIMONIO,87,87,174
8,2022,AIRE,NASCITA,338,271,609
8,2022,AIRE,RESIDENZA,315,364,679
8,2022,AIRE,STATO CIVILE,5,1,6
8,2022,AIRE,STATO FAMIGLIA,175,179,354
8,2022,AIRE,STATO FAMIGLIA CON RAPPORTI PARENTELA,7,4,11
8,2022,AIRE,STATO FAMIGLIA E STATO CIVILE,1,1,2
8,2022,AIRE,STATO LIBERO,2,0,2
8,2022,AIRE,UNIONE CIVILE ,0,3,3
8,2022,Residenti,CITTADINANZA,1382,1024,2406
8,2022,Residenti,CONTESTUALE,24096,35087,59183
8,2022,Residenti,CONTRATTO CONVIVENZA,13,11,24
8,2022,Residenti,ESISTENZA IN VITA,799,963,1762
8,2022,Residenti,ISCRIZIONE NELLE LISTE ELETTORALI,0,1,1
8,2022,Residenti,MATRIMONIO,5389,5998,11387
8,2022,Residenti,NASCITA,7909,8476,16385
8,2022,Residenti,RESIDENZA,27596,33917,61513
8,2022,Residenti,RESIDENZA IN CONVIVENZA,25,40,65
8,2022,Residenti,STATO CIVILE,4635,5117,9752
8,2022,Residenti,STATO FAMIGLIA,21741,29619,51360
8,2022,Residenti,STATO FAMIGLIA CON RAPPORTI PARENTELA,4242,5403,9645
8,2022,Residenti,STATO FAMIGLIA E STATO CIVILE,3427,4096,7523
8,2022,Residenti,STATO LIBERO,2327,1885,4212
8,2022,Residenti,UNIONE CIVILE ,32,35,67
9,2022,AIRE,CITTADINANZA,127,62,189
9,2022,AIRE,CONTESTUALE,330,290,620
9,2022,AIRE,ESISTENZA IN VITA,3,4,7
9,2022,AIRE,MATRIMONIO,118,123,241
9,2022,AIRE,NASCITA,301,276,577
9,2022,AIRE,RESIDENZA,297,403,700
9,2022,AIRE,STATO CIVILE,10,5,15
9,2022,AIRE,STATO FAMIGLIA,187,197,384
9,2022,AIRE,STATO FAMIGLIA CON RAPPORTI PARENTELA,7,3,10
9,2022,AIRE,STATO FAMIGLIA E STATO CIVILE,3,0,3
9,2022,AIRE,STATO LIBERO,3,4,7
9,2022,Residenti,CITTADINANZA,2250,1876,4126
9,2022,Residenti,CONTESTUALE,42838,85862,128700
9,2022,Residenti,CONTRATTO CONVIVENZA,11,21,32
9,2022,Residenti,ESISTENZA IN VITA,1358,1398,2756
9,2022,Residenti,MATRIMONIO,9561,12016,21577
9,2022,Residenti,NASCITA,11003,14304,25307
9,2022,Residenti,RESIDENZA,40637,53467,94104
9,2022,Residenti,RESIDENZA IN CONVIVENZA,53,59,112
9,2022,Residenti,STATO CIVILE,9356,10146,19502
9,2022,Residenti,STATO FAMIGLIA,35171,55505,90676
9,2022,Residenti,STATO FAMIGLIA CON RAPPORTI PARENTELA,6478,8542,15020
9,2022,Residenti,STATO FAMIGLIA E STATO CIVILE,5687,6984,12671
9,2022,Residenti,STATO LIBERO,5631,4879,10510
9,2022,Residenti,UNIONE CIVILE ,46,62,108
10,2022,AIRE,CITTADINANZA,121,73,194
10,2022,AIRE,CONTESTUALE,344,317,661
10,2022,AIRE,ESISTENZA IN VITA,1,0,1
10,2022,AIRE,MATRIMONIO,111,114,225
10,2022,AIRE,NASCITA,336,269,605
10,2022,AIRE,RESIDENZA,353,387,740
10,2022,AIRE,STATO CIVILE,13,6,19
10,2022,AIRE,STATO FAMIGLIA,197,208,405
10,2022,AIRE,STATO FAMIGLIA CON RAPPORTI PARENTELA,7,5,12
10,2022,AIRE,STATO FAMIGLIA E STATO CIVILE,5,3,8
10,2022,AIRE,STATO LIBERO,6,5,11
10,2022,Residenti,CITTADINANZA,2086,1751,3837
10,2022,Residenti,CONTESTUALE,42117,68123,110240
10,2022,Residenti,CONTRATTO CONVIVENZA,14,17,31
10,2022,Residenti,ESISTENZA IN VITA,1289,1428,2717
10,2022,Residenti,GODIMENTO DEI DIRITTI POLITICI,0,1,1
10,2022,Residenti,ISCRIZIONE NELLE LISTE ELETTORALI,0,1,1
10,2022,Residenti,MATRIMONIO,9494,11653,21147
10,2022,Residenti,NASCITA,10289,12910,23199
10,2022,Residenti,RESIDENZA,40361,52464,92825
10,2022,Residenti,RESIDENZA IN CONVIVENZA,50,50,100
10,2022,Residenti,STATO CIVILE,9050,9903,18953
10,2022,Residenti,STATO FAMIGLIA,35787,50437,86224
10,2022,Residenti,STATO FAMIGLIA CON RAPPORTI PARENTELA,6609,8441,15050
10,2022,Residenti,STATO FAMIGLIA E STATO CIVILE,6136,7373,13509
10,2022,Residenti,STATO LIBERO,5075,4548,9623
10,2022,Residenti,UNIONE CIVILE ,54,48,102
11,2022,AIRE,CITTADINANZA,145,66,211
11,2022,AIRE,CONTESTUALE,381,336,717
11,2022,AIRE,ESISTENZA IN VITA,2,1,3
11,2022,AIRE,MATRIMONIO,118,123,241
11,2022,AIRE,NASCITA,353,270,623
11,2022,AIRE,RESIDENZA,349,344,693
11,2022,AIRE,STATO CIVILE,9,3,12
11,2022,AIRE,STATO FAMIGLIA,204,197,401
11,2022,AIRE,STATO FAMIGLIA CON RAPPORTI PARENTELA,3,2,5
11,2022,AIRE,STATO FAMIGLIA E STATO CIVILE,4,6,10
11,2022,AIRE,STATO LIBERO,1,2,3
11,2022,AIRE,UNIONE CIVILE ,0,1,1
11,2022,Residenti,CITTADINANZA,2259,1693,3952
11,2022,Residenti,CONTESTUALE,40159,50179,90338
11,2022,Residenti,CONTRATTO CONVIVENZA,17,8,25
11,2022,Residenti,ESISTENZA IN VITA,1410,1599,3009
11,2022,Residenti,GODIMENTO DEI DIRITTI POLITICI,0,3,3
11,2022,Residenti,ISCRIZIONE NELLE LISTE ELETTORALI,0,1,1
11,2022,Residenti,MATRIMONIO,8825,11596,20421
11,2022,Residenti,NASCITA,10370,11897,22267
11,2022,Residenti,RESIDENZA,39661,48742,88403
11,2022,Residenti,RESIDENZA IN CONVIVENZA,50,48,98
11,2022,Residenti,STATO CIVILE,9669,10226,19895
11,2022,Residenti,STATO FAMIGLIA,33619,45357,78976
11,2022,Residenti,STATO FAMIGLIA CON RAPPORTI PARENTELA,6877,8579,15456
11,2022,Residenti,STATO FAMIGLIA E STATO CIVILE,5979,6981,12960
11,2022,Residenti,STATO LIBERO,5499,4990,10489
11,2022,Residenti,UNIONE CIVILE ,62,37,99
12,2022,AIRE,CITTADINANZA,168,59,227
12,2022,AIRE,CONTESTUALE,432,311,743
12,2022,AIRE,ESISTENZA IN VITA,1,1,2
12,2022,AIRE,MATRIMONIO,110,113,223
12,2022,AIRE,NASCITA,324,245,569
12,2022,AIRE,RESIDENZA,442,368,810
12,2022,AIRE,STATO CIVILE,8,6,14
12,2022,AIRE,STATO FAMIGLIA,241,187,428
12,2022,AIRE,STATO FAMIGLIA CON RAPPORTI PARENTELA,4,3,7
12,2022,AIRE,STATO FAMIGLIA E STATO CIVILE,2,2,4
12,2022,AIRE,STATO LIBERO,2,1,3
12,2022,AIRE,UNIONE CIVILE ,1,0,1
12,2022,Residenti,CITTADINANZA,2678,1381,4059
12,2022,Residenti,CONTESTUALE,34646,34599,69245
12,2022,Residenti,CONTRATTO CONVIVENZA,18,9,27
12,2022,Residenti,ESISTENZA IN VITA,1955,1538,3493
12,2022,Residenti,MATRIMONIO,7292,8389,15681
12,2022,Residenti,NASCITA,9745,9085,18830
12,2022,Residenti,RESIDENZA,35134,40062,75196
12,2022,Residenti,RESIDENZA IN CONVIVENZA,44,52,96
12,2022,Residenti,STATO CIVILE,8357,7921,16278
12,2022,Residenti,STATO FAMIGLIA,29668,35113,64781
12,2022,Residenti,STATO FAMIGLIA CON RAPPORTI PARENTELA,6629,6774,13403
12,2022,Residenti,STATO FAMIGLIA E STATO CIVILE,5833,5354,11187
12,2022,Residenti,STATO LIBERO,4852,3378,8230
12,2022,Residenti,UNIONE CIVILE ,42,35,77
1,2023,AIRE,CITTADINANZA,13,187,200
1,2023,AIRE,CONTESTUALE,38,823,861
1,2023,AIRE,ESISTENZA IN VITA,0,4,4
1,2023,AIRE,MATRIMONIO,14,221,235
1,2023,AIRE,NASCITA,29,572,601
1,2023,AIRE,RESIDENZA,35,898,933
1,2023,AIRE,STATO CIVILE,2,21,23
1,2023,AIRE,STATO FAMIGLIA,23,415,438
1,2023,AIRE,STATO FAMIGLIA CON RAPPORTI PARENTELA,0,11,11
1,2023,AIRE,STATO FAMIGLIA E STATO CIVILE,0,6,6
1,2023,AIRE,STATO LIBERO,1,10,11
1,2023,AIRE,UNIONE CIVILE ,0,2,2
1,2023,Residenti,CITTADINANZA,136,3170,3306
1,2023,Residenti,CONTESTUALE,2291,90095,92386
1,2023,Residenti,CONTRATTO CONVIVENZA,0,26,26
1,2023,Residenti,ESISTENZA IN VITA,105,2996,3101
1,2023,Residenti,MATRIMONIO,408,17712,18120
1,2023,Residenti,NASCITA,711,22001,22712
1,2023,Residenti,RESIDENZA,2469,93822,96291
1,2023,Residenti,RESIDENZA IN CONVIVENZA,4,116,120
1,2023,Residenti,STATO CIVILE,439,17622,18061
1,2023,Residenti,STATO FAMIGLIA,3223,117415,120638
1,2023,Residenti,STATO FAMIGLIA CON RAPPORTI PARENTELA,463,18717,19180
1,2023,Residenti,STATO FAMIGLIA E STATO CIVILE,454,15317,15771
1,2023,Residenti,STATO LIBERO,212,7724,7936
1,2023,Residenti,UNIONE CIVILE ,2,76,78
2,2023,AIRE,CITTADINANZA,0,183,183
2,2023,AIRE,CONTESTUALE,0,735,735
2,2023,AIRE,ESISTENZA IN VITA,0,2,2
2,2023,AIRE,MATRIMONIO,0,232,232
2,2023,AIRE,NASCITA,0,597,597
2,2023,AIRE,RESIDENZA,0,753,753
2,2023,AIRE,STATO CIVILE,0,21,21
2,2023,AIRE,STATO FAMIGLIA,0,410,410
2,2023,AIRE,STATO FAMIGLIA CON RAPPORTI PARENTELA,0,11,11
2,2023,AIRE,STATO FAMIGLIA E STATO CIVILE,0,11,11
2,2023,AIRE,STATO LIBERO,0,11,11
2,2023,AIRE,UNIONE CIVILE ,0,6,6
2,2023,Residenti,CITTADINANZA,0,2963,2963
2,2023,Residenti,CONTESTUALE,0,86217,86217
2,2023,Residenti,CONTRATTO CONVIVENZA,0,18,18
2,2023,Residenti,ESISTENZA IN VITA,0,2287,2287
2,2023,Residenti,MATRIMONIO,0,18138,18138
2,2023,Residenti,NASCITA,0,19860,19860
2,2023,Residenti,RESIDENZA,0,87926,87926
2,2023,Residenti,RESIDENZA IN CONVIVENZA,0,106,106
2,2023,Residenti,STATO CIVILE,0,17807,17807
2,2023,Residenti,STATO FAMIGLIA,0,88389,88389
2,2023,Residenti,STATO FAMIGLIA CON RAPPORTI PARENTELA,0,14599,14599
2,2023,Residenti,STATO FAMIGLIA E STATO CIVILE,0,12997,12997
2,2023,Residenti,STATO LIBERO,0,8333,8333
2,2023,Residenti,UNIONE CIVILE ,0,79,79
3,2023,AIRE,CITTADINANZA,0,185,185
3,2023,AIRE,CONTESTUALE,0,763,763
3,2023,AIRE,ESISTENZA IN VITA,0,6,6
3,2023,AIRE,MATRIMONIO,0,284,284
3,2023,AIRE,NASCITA,0,561,561
3,2023,AIRE,RESIDENZA,0,896,896
3,2023,AIRE,STATO CIVILE,0,21,21
3,2023,AIRE,STATO FAMIGLIA,0,391,391
3,2023,AIRE,STATO FAMIGLIA CON RAPPORTI PARENTELA,0,14,14
3,2023,AIRE,STATO FAMIGLIA E STATO CIVILE,0,8,8
3,2023,AIRE,STATO LIBERO,0,8,8
3,2023,AIRE,UNIONE CIVILE ,0,2,2
3,2023,Residenti,CITTADINANZA,0,2958,2958
3,2023,Residenti,CONTESTUALE,0,85727,85727
3,2023,Residenti,CONTRATTO CONVIVENZA,0,23,23
3,2023,Residenti,ESISTENZA IN VITA,0,2344,2344
3,2023,Residenti,MATRIMONIO,0,17006,17006
3,2023,Residenti,NASCITA,0,19904,19904
3,2023,Residenti,RESIDENZA,0,88562,88562
3,2023,Residenti,RESIDENZA IN CONVIVENZA,0,101,101
3,2023,Residenti,STATO CIVILE,0,17278,17278
3,2023,Residenti,STATO FAMIGLIA,0,77967,77967
3,2023,Residenti,STATO FAMIGLIA CON RAPPORTI PARENTELA,0,13171,13171
3,2023,Residenti,STATO FAMIGLIA E STATO CIVILE,0,11765,11765
3,2023,Residenti,STATO LIBERO,0,7661,7661
3,2023,Residenti,UNIONE CIVILE ,0,81,81
4,2023,AIRE,CITTADINANZA,0,155,155
4,2023,AIRE,CONTESTUALE,0,623,623
4,2023,AIRE,ESISTENZA IN VITA,0,4,4
4,2023,AIRE,MATRIMONIO,0,189,189
4,2023,AIRE,NASCITA,0,444,444
4,2023,AIRE,RESIDENZA,0,698,698
4,2023,AIRE,STATO CIVILE,0,15,15
4,2023,AIRE,STATO FAMIGLIA,0,326,326
4,2023,AIRE,STATO FAMIGLIA CON RAPPORTI PARENTELA,0,4,4
4,2023,AIRE,STATO FAMIGLIA E STATO CIVILE,0,4,4
4,2023,AIRE,STATO LIBERO,0,7,7
4,2023,AIRE,UNIONE CIVILE ,0,3,3
4,2023,Residenti,CITTADINANZA,0,2346,2346
4,2023,Residenti,CONTESTUALE,0,63609,63609
4,2023,Residenti,CONTRATTO CONVIVENZA,0,13,13
4,2023,Residenti,ESISTENZA IN VITA,0,1628,1628
4,2023,Residenti,MATRIMONIO,0,11893,11893
4,2023,Residenti,NASCITA,0,14547,14547
4,2023,Residenti,RESIDENZA,0,69061,69061
4,2023,Residenti,RESIDENZA IN CONVIVENZA,0,88,88
4,2023,Residenti,STATO CIVILE,0,12478,12478
4,2023,Residenti,STATO FAMIGLIA,0,54513,54513
4,2023,Residenti,STATO FAMIGLIA CON RAPPORTI PARENTELA,0,9424,9424
4,2023,Residenti,STATO FAMIGLIA E STATO CIVILE,0,8590,8590
4,2023,Residenti,STATO LIBERO,0,5507,5507
4,2023,Residenti,UNIONE CIVILE ,0,63,63
5,2023,AIRE,CITTADINANZA,0,139,139
5,2023,AIRE,CONTESTUALE,0,618,618
5,2023,AIRE,ESISTENZA IN VITA,0,4,4
5,2023,AIRE,MATRIMONIO,0,238,238
5,2023,AIRE,NASCITA,0,448,448
5,2023,AIRE,RESIDENZA,0,789,789
5,2023,AIRE,STATO CIVILE,0,16,16
5,2023,AIRE,STATO FAMIGLIA,0,381,381
5,2023,AIRE,STATO FAMIGLIA CON RAPPORTI PARENTELA,0,8,8
5,2023,AIRE,STATO FAMIGLIA E STATO CIVILE,0,11,11
5,2023,AIRE,STATO LIBERO,0,8,8
5,2023,AIRE,UNIONE CIVILE ,0,4,4
5,2023,Residenti,CITTADINANZA,0,2759,2759
5,2023,Residenti,CONTESTUALE,0,78296,78296
5,2023,Residenti,CONTRATTO CONVIVENZA,0,14,14
5,2023,Residenti,ESISTENZA IN VITA,0,1959,1959
5,2023,Residenti,MATRIMONIO,0,16014,16014
5,2023,Residenti,NASCITA,0,17402,17402
5,2023,Residenti,RESIDENZA,0,84728,84728
5,2023,Residenti,RESIDENZA IN CONVIVENZA,0,118,118
5,2023,Residenti,STATO CIVILE,0,15940,15940
5,2023,Residenti,STATO FAMIGLIA,0,65982,65982
5,2023,Residenti,STATO FAMIGLIA CON RAPPORTI PARENTELA,0,11086,11086
5,2023,Residenti,STATO FAMIGLIA E STATO CIVILE,0,10375,10375
5,2023,Residenti,STATO LIBERO,0,6470,6470
5,2023,Residenti,UNIONE CIVILE ,0,95,95
6,2023,AIRE,CITTADINANZA,0,121,121
6,2023,AIRE,CONTESTUALE,0,583,583
6,2023,AIRE,ESISTENZA IN VITA,0,3,3
6,2023,AIRE,MATRIMONIO,0,181,181
6,2023,AIRE,NASCITA,0,462,462
6,2023,AIRE,RESIDENZA,0,756,756
6,2023,AIRE,STATO CIVILE,0,13,13
6,2023,AIRE,STATO FAMIGLIA,0,312,312
6,2023,AIRE,STATO FAMIGLIA CON RAPPORTI PARENTELA,0,4,4
6,2023,AIRE,STATO FAMIGLIA E STATO CIVILE,0,3,3
6,2023,AIRE,STATO LIBERO,0,6,6
6,2023,Residenti,CITTADINANZA,0,2485,2485
6,2023,Residenti,CONTESTUALE,0,67659,67659
6,2023,Residenti,CONTRATTO CONVIVENZA,0,11,11
6,2023,Residenti,ESISTENZA IN VITA,0,2083,2083
6,2023,Residenti,MATRIMONIO,0,14685,14685
6,2023,Residenti,NASCITA,0,15887,15887
6,2023,Residenti,RESIDENZA,0,75568,75568
6,2023,Residenti,RESIDENZA IN CONVIVENZA,0,85,85
6,2023,Residenti,STATO CIVILE,0,13707,13707
6,2023,Residenti,STATO FAMIGLIA,0,59976,59976
6,2023,Residenti,STATO FAMIGLIA CON RAPPORTI PARENTELA,0,10309,10309
6,2023,Residenti,STATO FAMIGLIA E STATO CIVILE,0,9035,9035
6,2023,Residenti,STATO LIBERO,0,5754,5754
6,2023,Residenti,UNIONE CIVILE ,0,70,70
7,2023,AIRE,CITTADINANZA,0,149,149
7,2023,AIRE,CONTESTUALE,0,604,604
7,2023,AIRE,ESISTENZA IN VITA,0,3,3
7,2023,AIRE,MATRIMONIO,0,196,196
7,2023,AIRE,NASCITA,0,478,478
7,2023,AIRE,RESIDENZA,0,648,648
7,2023,AIRE,STATO CIVILE,0,15,15
7,2023,AIRE,STATO FAMIGLIA,0,305,305
7,2023,AIRE,STATO FAMIGLIA CON RAPPORTI PARENTELA,0,5,5
7,2023,AIRE,STATO FAMIGLIA E STATO CIVILE,0,4,4
7,2023,AIRE,STATO LIBERO,0,7,7
7,2023,AIRE,UNIONE CIVILE ,0,6,6
7,2023,Residenti,CITTADINANZA,0,2205,2205
7,2023,Residenti,CONTESTUALE,0,83826,83826
7,2023,Residenti,CONTRATTO CONVIVENZA,0,16,16
7,2023,Residenti,ESISTENZA IN VITA,0,1835,1835
7,2023,Residenti,MATRIMONIO,0,14339,14339
7,2023,Residenti,NASCITA,0,16022,16022
7,2023,Residenti,RESIDENZA,0,73460,73460
7,2023,Residenti,RESIDENZA IN CONVIVENZA,0,90,90
7,2023,Residenti,STATO CIVILE,0,12769,12769
7,2023,Residenti,STATO FAMIGLIA,0,64326,64326
7,2023,Residenti,STATO FAMIGLIA CON RAPPORTI PARENTELA,0,10551,10551
7,2023,Residenti,STATO FAMIGLIA E STATO CIVILE,0,8315,8315
7,2023,Residenti,STATO LIBERO,0,5152,5152
7,2023,Residenti,UNIONE CIVILE ,0,97,97
8,2023,AIRE,CITTADINANZA,9,86,95
8,2023,AIRE,CONTESTUALE,61,373,434
8,2023,AIRE,MATRIMONIO,23,140,163
8,2023,AIRE,NASCITA,96,327,423
8,2023,AIRE,RESIDENZA,100,469,569
8,2023,AIRE,STATO CIVILE,2,9,11
8,2023,AIRE,STATO FAMIGLIA,22,205,227
8,2023,AIRE,STATO FAMIGLIA CON RAPPORTI PARENTELA,1,2,3
8,2023,AIRE,STATO FAMIGLIA E STATO CIVILE,0,1,1
8,2023,AIRE,STATO LIBERO,2,1,3
8,2023,AIRE,UNIONE CIVILE ,1,1,2
8,2023,Residenti,CITTADINANZA,69,1771,1840
8,2023,Residenti,CONTESTUALE,5211,61036,66247
8,2023,Residenti,CONTRATTO CONVIVENZA,3,13,16
8,2023,Residenti,ESISTENZA IN VITA,90,1037,1127
8,2023,Residenti,MATRIMONIO,744,7646,8390
8,2023,Residenti,NASCITA,1165,11388,12553
8,2023,Residenti,RESIDENZA,3281,52740,56021
8,2023,Residenti,RESIDENZA IN CONVIVENZA,1,57,58
8,2023,Residenti,STATO CIVILE,692,6591,7283
8,2023,Residenti,STATO FAMIGLIA,3373,43448,46821
8,2023,Residenti,STATO FAMIGLIA CON RAPPORTI PARENTELA,503,7211,7714
8,2023,Residenti,STATO FAMIGLIA E STATO CIVILE,417,5582,5999
8,2023,Residenti,STATO LIBERO,768,2109,2877
8,2023,Residenti,UNIONE CIVILE ,10,49,59
9,2023,AIRE,CITTADINANZA,11,104,115
9,2023,AIRE,CONTESTUALE,89,429,518
9,2023,AIRE,ESISTENZA IN VITA,0,1,1
9,2023,AIRE,MATRIMONIO,30,182,212
9,2023,AIRE,NASCITA,133,280,413
9,2023,AIRE,RESIDENZA,123,511,634
9,2023,AIRE,STATO CIVILE,1,8,9
9,2023,AIRE,STATO FAMIGLIA,38,240,278
9,2023,AIRE,STATO FAMIGLIA CON RAPPORTI PARENTELA,0,7,7
9,2023,AIRE,STATO FAMIGLIA E STATO CIVILE,0,8,8
9,2023,AIRE,STATO LIBERO,4,7,11
9,2023,AIRE,UNIONE CIVILE ,1,0,1
9,2023,Residenti,CITTADINANZA,104,2183,2287
9,2023,Residenti,CONTESTUALE,9129,133584,142713
9,2023,Residenti,CONTRATTO CONVIVENZA,1,9,10
9,2023,Residenti,ESISTENZA IN VITA,148,1533,1681
9,2023,Residenti,MATRIMONIO,1601,13139,14740
9,2023,Residenti,NASCITA,1649,17415,19064
9,2023,Residenti,RESIDENZA,5167,73802,78969
9,2023,Residenti,RESIDENZA IN CONVIVENZA,2,76,78
9,2023,Residenti,STATO CIVILE,2008,12167,14175
9,2023,Residenti,STATO FAMIGLIA,5681,73242,78923
9,2023,Residenti,STATO FAMIGLIA CON RAPPORTI PARENTELA,721,10996,11717
9,2023,Residenti,STATO FAMIGLIA E STATO CIVILE,789,9022,9811
9,2023,Residenti,STATO LIBERO,1924,4387,6311
9,2023,Residenti,UNIONE CIVILE ,13,76,89
10,2023,AIRE,CITTADINANZA,6,99,105
10,2023,AIRE,CONTESTUALE,110,469,579
10,2023,AIRE,ESISTENZA IN VITA,0,2,2
10,2023,AIRE,MATRIMONIO,24,183,207
10,2023,AIRE,NASCITA,96,360,456
10,2023,AIRE,RESIDENZA,124,665,789
10,2023,AIRE,STATO CIVILE,2,10,12
10,2023,AIRE,STATO FAMIGLIA,36,257,293
10,2023,AIRE,STATO FAMIGLIA CON RAPPORTI PARENTELA,0,6,6
10,2023,AIRE,STATO FAMIGLIA E STATO CIVILE,0,4,4
10,2023,AIRE,STATO LIBERO,3,1,4
10,2023,AIRE,UNIONE CIVILE ,0,1,1
10,2023,Residenti,CITTADINANZA,127,2358,2485
10,2023,Residenti,CONTESTUALE,10173,103188,113361
10,2023,Residenti,CONTRATTO CONVIVENZA,3,16,19
10,2023,Residenti,ESISTENZA IN VITA,181,1815,1996
10,2023,Residenti,MATRIMONIO,1658,14725,16383
10,2023,Residenti,NASCITA,1524,16878,18402
10,2023,Residenti,RESIDENZA,5588,76205,81793
10,2023,Residenti,RESIDENZA IN CONVIVENZA,5,95,100
10,2023,Residenti,STATO CIVILE,2150,12689,14839
10,2023,Residenti,STATO FAMIGLIA,5660,68709,74369
10,2023,Residenti,STATO FAMIGLIA CON RAPPORTI PARENTELA,774,10949,11723
10,2023,Residenti,STATO FAMIGLIA E STATO CIVILE,905,9516,10421
10,2023,Residenti,STATO LIBERO,2132,4550,6682
10,2023,Residenti,UNIONE CIVILE ,9,73,82
11,2023,AIRE,CITTADINANZA,7,108,115
11,2023,AIRE,CONTESTUALE,102,446,548
11,2023,AIRE,MATRIMONIO,21,172,193
11,2023,AIRE,NASCITA,136,313,449
11,2023,AIRE,RESIDENZA,125,603,728
11,2023,AIRE,STATO CIVILE,3,6,9
11,2023,AIRE,STATO FAMIGLIA,28,244,272
11,2023,AIRE,STATO FAMIGLIA CON RAPPORTI PARENTELA,0,5,5
11,2023,AIRE,STATO FAMIGLIA E STATO CIVILE,1,0,1
11,2023,AIRE,STATO LIBERO,1,4,5
11,2023,Residenti,CITTADINANZA,92,1965,2057
11,2023,Residenti,CONTESTUALE,9611,69650,79261
11,2023,Residenti,CONTRATTO CONVIVENZA,1,10,11
11,2023,Residenti,ESISTENZA IN VITA,177,1817,1994
11,2023,Residenti,MATRIMONIO,1390,13322,14712
11,2023,Residenti,NASCITA,1436,14156,15592
11,2023,Residenti,RESIDENZA,4962,70216,75178
11,2023,Residenti,RESIDENZA IN CONVIVENZA,1,66,67
11,2023,Residenti,STATO CIVILE,2107,11992,14099
11,2023,Residenti,STATO FAMIGLIA,5476,60609,66085
11,2023,Residenti,STATO FAMIGLIA CON RAPPORTI PARENTELA,771,10650,11421
11,2023,Residenti,STATO FAMIGLIA E STATO CIVILE,817,8707,9524
11,2023,Residenti,STATO LIBERO,2405,4894,7299
11,2023,Residenti,UNIONE CIVILE ,21,69,90
12,2023,AIRE,CITTADINANZA,14,88,102
12,2023,AIRE,CONTESTUALE,110,428,538
12,2023,AIRE,ESISTENZA IN VITA,0,2,2
12,2023,AIRE,MATRIMONIO,24,150,174
12,2023,AIRE,NASCITA,105,281,386
12,2023,AIRE,RESIDENZA,89,611,700
12,2023,AIRE,STATO CIVILE,2,9,11
12,2023,AIRE,STATO FAMIGLIA,25,220,245
12,2023,AIRE,STATO FAMIGLIA CON RAPPORTI PARENTELA,0,7,7
12,2023,AIRE,STATO FAMIGLIA E STATO CIVILE,0,3,3
12,2023,AIRE,STATO LIBERO,2,2,4
12,2023,AIRE,UNIONE CIVILE ,1,0,1
12,2023,Residenti,CITTADINANZA,97,1834,1931
12,2023,Residenti,CONTESTUALE,7665,60112,67777
12,2023,Residenti,CONTRATTO CONVIVENZA,2,10,12
12,2023,Residenti,ESISTENZA IN VITA,166,2268,2434
12,2023,Residenti,MATRIMONIO,997,10985,11982
12,2023,Residenti,NASCITA,1243,12139,13382
12,2023,Residenti,RESIDENZA,4303,125670,129973
12,2023,Residenti,RESIDENZA IN CONVIVENZA,1,68,69
12,2023,Residenti,STATO CIVILE,1614,10018,11632
12,2023,Residenti,STATO FAMIGLIA,4539,50126,54665
12,2023,Residenti,STATO FAMIGLIA CON RAPPORTI PARENTELA,715,8128,8843
12,2023,Residenti,STATO FAMIGLIA E STATO CIVILE,647,6560,7207
12,2023,Residenti,STATO LIBERO,1699,3721,5420
12,2023,Residenti,UNIONE CIVILE ,8,52,60
1,2024,AIRE,CITTADINANZA,14,94,108
1,2024,AIRE,CONTESTUALE,118,553,671
1,2024,AIRE,MATRIMONIO,32,181,213
1,2024,AIRE,NASCITA,185,354,539
1,2024,AIRE,RESIDENZA,141,892,1033
1,2024,AIRE,STATO CIVILE,2,9,11
1,2024,AIRE,STATO FAMIGLIA,32,286,318
1,2024,AIRE,STATO FAMIGLIA CON RAPPORTI PARENTELA,1,4,5
1,2024,AIRE,STATO FAMIGLIA E STATO CIVILE,0,2,2
1,2024,AIRE,STATO LIBERO,2,8,10
1,2024,AIRE,UNIONE CIVILE ,0,2,2
1,2024,Residenti,CITTADINANZA,138,2736,2874
1,2024,Residenti,CONTESTUALE,11915,109154,121069
1,2024,Residenti,CONTRATTO CONVIVENZA,1,23,24
1,2024,Residenti,ESISTENZA IN VITA,211,4536,4747
1,2024,Residenti,MATRIMONIO,1366,17051,18417
1,2024,Residenti,NASCITA,1841,19413,21254
1,2024,Residenti,RESIDENZA,6062,245113,251175
1,2024,Residenti,RESIDENZA IN CONVIVENZA,0,172,172
1,2024,Residenti,STATO CIVILE,2072,16074,18146
1,2024,Residenti,STATO FAMIGLIA,7782,110300,118082
1,2024,Residenti,STATO FAMIGLIA CON RAPPORTI PARENTELA,1118,14372,15490
1,2024,Residenti,STATO FAMIGLIA E STATO CIVILE,1009,11884,12893
1,2024,Residenti,STATO LIBERO,2252,5135,7387
1,2024,Residenti,UNIONE CIVILE ,11,81,92
2,2024,AIRE,CITTADINANZA,13,141,154
2,2024,AIRE,CONTESTUALE,130,499,629
2,2024,AIRE,ESISTENZA IN VITA,0,1,1
2,2024,AIRE,MATRIMONIO,31,161,192
2,2024,AIRE,NASCITA,180,397,577
2,2024,AIRE,RESIDENZA,138,1037,1175
2,2024,AIRE,STATO CIVILE,2,10,12
2,2024,AIRE,STATO FAMIGLIA,22,298,320
2,2024,AIRE,STATO FAMIGLIA CON RAPPORTI PARENTELA,1,8,9
2,2024,AIRE,STATO FAMIGLIA E STATO CIVILE,0,4,4
2,2024,AIRE,STATO LIBERO,2,4,6
2,2024,AIRE,UNIONE CIVILE ,1,1,2
2,2024,Residenti,CITTADINANZA,121,2780,2901
2,2024,Residenti,CONTESTUALE,13361,118314,131675
2,2024,Residenti,CONTRATTO CONVIVENZA,3,20,23
2,2024,Residenti,ESISTENZA IN VITA,181,3888,4069
2,2024,Residenti,MATRIMONIO,1278,18834,20112
2,2024,Residenti,NASCITA,1753,19842,21595
2,2024,Residenti,RESIDENZA,5833,270518,276351
2,2024,Residenti,RESIDENZA IN CONVIVENZA,4,212,216
2,2024,Residenti,STATO CIVILE,2151,17124,19275
2,2024,Residenti,STATO FAMIGLIA,7075,92573,99648
2,2024,Residenti,STATO FAMIGLIA CON RAPPORTI PARENTELA,860,11621,12481
2,2024,Residenti,STATO FAMIGLIA E STATO CIVILE,1039,10540,11579
2,2024,Residenti,STATO LIBERO,2396,5528,7924
2,2024,Residenti,UNIONE CIVILE ,10,91,101
3,2024,AIRE,CITTADINANZA,10,107,117
3,2024,AIRE,CONTESTUALE,139,602,741
3,2024,AIRE,ESISTENZA IN VITA,0,1,1
3,2024,AIRE,GODIMENTO DEI DIRITTI POLITICI,0,8,8
3,2024,AIRE,ISCRIZIONE NELLE LISTE ELETTORALI,2,13,15
3,2024,AIRE,MATRIMONIO,22,189,211
3,2024,AIRE,NASCITA,176,440,616
3,2024,AIRE,RESIDENZA,162,1122,1284
3,2024,AIRE,STATO CIVILE,3,10,13
3,2024,AIRE,STATO FAMIGLIA,27,293,320
3,2024,AIRE,STATO FAMIGLIA CON RAPPORTI PARENTELA,0,1,1
3,2024,AIRE,STATO FAMIGLIA E STATO CIVILE,1,6,7
3,2024,AIRE,STATO LIBERO,3,3,6
3,2024,AIRE,UNIONE CIVILE ,1,5,6
3,2024,Residenti,CITTADINANZA,162,2824,2986
3,2024,Residenti,CONTESTUALE,17103,124809,141912
3,2024,Residenti,CONTRATTO CONVIVENZA,4,16,20
3,2024,Residenti,ESISTENZA IN VITA,182,3352,3534
3,2024,Residenti,GODIMENTO DEI DIRITTI POLITICI,53,282,335
3,2024,Residenti,ISCRIZIONE NELLE LISTE ELETTORALI,15,800,815
3,2024,Residenti,MATRIMONIO,1352,18006,19358
3,2024,Residenti,NASCITA,1716,19344,21060
3,2024,Residenti,RESIDENZA,6087,268376,274463
3,2024,Residenti,RESIDENZA IN CONVIVENZA,4,223,227
3,2024,Residenti,STATO CIVILE,2132,16834,18966
3,2024,Residenti,STATO FAMIGLIA,6717,84504,91221
3,2024,Residenti,STATO FAMIGLIA CON RAPPORTI PARENTELA,861,10374,11235
3,2024,Residenti,STATO FAMIGLIA E STATO CIVILE,988,9531,10519
3,2024,Residenti,STATO LIBERO,2455,5510,7965
3,2024,Residenti,UNIONE CIVILE ,7,90,97
4,2024,AIRE,CITTADINANZA,18,129,147
4,2024,AIRE,CONTESTUALE,142,599,741
4,2024,AIRE,GODIMENTO DEI DIRITTI POLITICI,2,10,12
4,2024,AIRE,ISCRIZIONE NELLE LISTE ELETTORALI,3,16,19
4,2024,AIRE,MATRIMONIO,30,165,195
4,2024,AIRE,NASCITA,147,399,546
4,2024,AIRE,RESIDENZA,196,1089,1285
4,2024,AIRE,STATO CIVILE,2,5,7
4,2024,AIRE,STATO FAMIGLIA,42,272,314
4,2024,AIRE,STATO FAMIGLIA CON RAPPORTI PARENTELA,0,4,4
4,2024,AIRE,STATO FAMIGLIA E STATO CIVILE,0,4,4
4,2024,AIRE,STATO LIBERO,1,4,5
4,2024,AIRE,UNIONE CIVILE ,1,0,1
4,2024,Residenti,CITTADINANZA,118,2807,2925
4,2024,Residenti,CONTESTUALE,13865,117391,131256
4,2024,Residenti,CONTRATTO CONVIVENZA,3,15,18
4,2024,Residenti,ESISTENZA IN VITA,170,3141,3311
4,2024,Residenti,GODIMENTO DEI DIRITTI POLITICI,66,785,851
4,2024,Residenti,ISCRIZIONE NELLE LISTE ELETTORALI,110,7677,7787
4,2024,Residenti,MATRIMONIO,1310,17760,19070
4,2024,Residenti,NASCITA,1815,18612,20427
4,2024,Residenti,RESIDENZA,5746,258667,264413
4,2024,Residenti,RESIDENZA IN CONVIVENZA,2,210,212
4,2024,Residenti,STATO CIVILE,2177,16392,18569
4,2024,Residenti,STATO FAMIGLIA,6331,79204,85535
4,2024,Residenti,STATO FAMIGLIA CON RAPPORTI PARENTELA,814,9540,10354
4,2024,Residenti,STATO FAMIGLIA E STATO CIVILE,936,9153,10089
4,2024,Residenti,STATO LIBERO,2563,5444,8007
4,2024,Residenti,UNIONE CIVILE ,15,78,93
5,2024,AIRE,CITTADINANZA,17,112,129
5,2024,AIRE,CONTESTUALE,129,652,781
5,2024,AIRE,ESISTENZA IN VITA,0,3,3
5,2024,AIRE,GODIMENTO DEI DIRITTI POLITICI,1,9,10
5,2024,AIRE,ISCRIZIONE NELLE LISTE ELETTORALI,4,58,62
5,2024,AIRE,MATRIMONIO,29,203,232
5,2024,AIRE,NASCITA,134,355,489
5,2024,AIRE,RESIDENZA,156,1104,1260
5,2024,AIRE,STATO CIVILE,0,11,11
5,2024,AIRE,STATO FAMIGLIA,46,287,333
5,2024,AIRE,STATO FAMIGLIA E STATO CIVILE,1,1,2
5,2024,AIRE,STATO LIBERO,0,1,1
5,2024,AIRE,UNIONE CIVILE ,2,5,7
5,2024,Residenti,CITTADINANZA,120,3184,3304
5,2024,Residenti,CONTESTUALE,14814,134260,149074
5,2024,Residenti,CONTRATTO CONVIVENZA,4,21,25
5,2024,Residenti,ESISTENZA IN VITA,193,3582,3775
5,2024,Residenti,GODIMENTO DEI DIRITTI POLITICI,101,1182,1283
5,2024,Residenti,ISCRIZIONE NELLE LISTE ELETTORALI,95,7994,8089
5,2024,Residenti,MATRIMONIO,1734,20578,22312
5,2024,Residenti,NASCITA,1842,21935,23777
5,2024,Residenti,RESIDENZA,6076,297297,303373
5,2024,Residenti,RESIDENZA IN CONVIVENZA,4,174,178
5,2024,Residenti,STATO CIVILE,2696,19611,22307
5,2024,Residenti,STATO FAMIGLIA,7228,90474,97702
5,2024,Residenti,STATO FAMIGLIA CON RAPPORTI PARENTELA,968,11057,12025
5,2024,Residenti,STATO FAMIGLIA E STATO CIVILE,1096,9917,11013
5,2024,Residenti,STATO LIBERO,2884,6635,9519
5,2024,Residenti,UNIONE CIVILE ,13,87,100