MESE,ANNO,TIPO SOGGETTO,TIPOLOGIA CERTIFICATO,BOLLO,ESENTI DA BOLLO,TOTALE
11,2021,AIRE,CITTADINANZA,296,191,487
11,2021,AIRE,CONTESTUALE,914,814,1728
11,2021,AIRE,ESISTENZA IN VITA,3,0,3
11,2021,AIRE,MATRIMONIO,222,270,492
11,2021,AIRE,NASCITA,448,380,828
11,2021,AIRE,RESIDENZA,648,695,1343
11,2021,AIRE,STATO CIVILE,11,4,15
11,2021,AIRE,STATO FAMIGLIA,364,410,774
11,2021,AIRE,STATO FAMIGLIA CON RAPPORTI PARENTELA,2,0,2
11,2021,AIRE,STATO FAMIGLIA E STATO CIVILE,4,2,6
11,2021,AIRE,STATO LIBERO,3,1,4
11,2021,AIRE,UNIONE CIVILE ,0,4,4
11,2021,Residenti,CITTADINANZA,4969,3810,8779
11,2021,Residenti,CONTESTUALE,52344,54324,106668
11,2021,Residenti,CONTRATTO CONVIVENZA,24,11,35
11,2021,Residenti,ESISTENZA IN VITA,4463,4939,9402
11,2021,Residenti,MATRIMONIO,14114,21302,35416
11,2021,Residenti,NASCITA,21973,29828,51801
11,2021,Residenti,RESIDENZA,40055,51696,91751
11,2021,Residenti,RESIDENZA IN CONVIVENZA,47,63,110
11,2021,Residenti,STATO CIVILE,11070,11852,22922
11,2021,Residenti,STATO FAMIGLIA,35594,48838,84432
11,2021,Residenti,STATO FAMIGLIA CON RAPPORTI PARENTELA,12198,15355,27553
11,2021,Residenti,STATO FAMIGLIA E STATO CIVILE,11152,13994,25146
11,2021,Residenti,STATO LIBERO,5464,3732,9196
11,2021,Residenti,UNIONE CIVILE ,178,158,336
12,2021,AIRE,CITTADINANZA,155,104,259
12,2021,AIRE,CONTESTUALE,450,306,756
12,2021,AIRE,ESISTENZA IN VITA,4,0,4
12,2021,AIRE,MATRIMONIO,177,140,317
12,2021,AIRE,NASCITA,308,242,550
12,2021,AIRE,RESIDENZA,425,400,825
12,2021,AIRE,STATO CIVILE,6,2,8
12,2021,AIRE,STATO FAMIGLIA,229,215,444
12,2021,AIRE,STATO FAMIGLIA CON RAPPORTI PARENTELA,0,2,2
12,2021,AIRE,STATO FAMIGLIA E STATO CIVILE,4,2,6
12,2021,AIRE,STATO LIBERO,2,0,2
12,2021,AIRE,UNIONE CIVILE ,2,3,5
12,2021,Residenti,CITTADINANZA,3230,1403,4633
12,2021,Residenti,CONTESTUALE,35865,30891,66756
12,2021,Residenti,CONTRATTO CONVIVENZA,7,6,13
12,2021,Residenti,ESISTENZA IN VITA,2617,2024,4641
12,2021,Residenti,MATRIMONIO,8806,9431,18237
12,2021,Residenti,NASCITA,12038,11044,23082
12,2021,Residenti,RESIDENZA,31680,35641,67321
12,2021,Residenti,RESIDENZA IN CONVIVENZA,37,30,67
12,2021,Residenti,STATO CIVILE,8767,7205,15972
12,2021,Residenti,STATO FAMIGLIA,29047,33571,62618
12,2021,Residenti,STATO FAMIGLIA CON RAPPORTI PARENTELA,7593,7138,14731
12,2021,Residenti,STATO FAMIGLIA E STATO CIVILE,7126,6229,13355
12,2021,Residenti,STATO LIBERO,5043,3007,8050
12,2021,Residenti,UNIONE CIVILE ,37,39,76
1,2022,AIRE,CITTADINANZA,150,88,238
1,2022,AIRE,CONTESTUALE,375,316,691
1,2022,AIRE,ESISTENZA IN VITA,0,1,1
1,2022,AIRE,MATRIMONIO,112,132,244
1,2022,AIRE,NASCITA,320,279,599
1,2022,AIRE,RESIDENZA,316,335,651
1,2022,AIRE,STATO CIVILE,6,6,12
1,2022,AIRE,STATO FAMIGLIA,188,214,402
1,2022,AIRE,STATO FAMIGLIA CON RAPPORTI PARENTELA,2,2,4
1,2022,AIRE,STATO FAMIGLIA E STATO CIVILE,1,1,2
1,2022,AIRE,STATO LIBERO,5,2,7
1,2022,AIRE,UNIONE CIVILE ,1,2,3
1,2022,Residenti,CITTADINANZA,1749,1566,3315
1,2022,Residenti,CONTESTUALE,39565,39426,78991
1,2022,Residenti,CONTRATTO CONVIVENZA,19,9,28
1,2022,Residenti,ESISTENZA IN VITA,1682,2247,3929
1,2022,Residenti,MATRIMONIO,8089,10955,19044
1,2022,Residenti,NASCITA,11233,12612,23845
1,2022,Residenti,RESIDENZA,36023,47576,83599
1,2022,Residenti,RESIDENZA IN CONVIVENZA,46,41,87
1,2022,Residenti,STATO CIVILE,8081,8846,16927
1,2022,Residenti,STATO FAMIGLIA,47611,61255,108866
1,2022,Residenti,STATO FAMIGLIA CON RAPPORTI PARENTELA,8204,10508,18712
1,2022,Residenti,STATO FAMIGLIA E STATO CIVILE,7430,8964,16394
1,2022,Residenti,STATO LIBERO,5083,3633,8716
1,2022,Residenti,UNIONE CIVILE ,35,40,75
2,2022,AIRE,CITTADINANZA,102,76,178
2,2022,AIRE,CONTESTUALE,330,330,660
2,2022,AIRE,ESISTENZA IN VITA,1,1,2
2,2022,AIRE,MATRIMONIO,105,135,240
2,2022,AIRE,NASCITA,302,248,550
2,2022,AIRE,RESIDENZA,319,339,658
2,2022,AIRE,STATO CIVILE,1,7,8
2,2022,AIRE,STATO FAMIGLIA,187,189,376
2,2022,AIRE,STATO FAMIGLIA CON RAPPORTI PARENTELA,0,5,5
2,2022,AIRE,STATO FAMIGLIA E STATO CIVILE,2,3,5
2,2022,AIRE,STATO LIBERO,0,1,1
2,2022,AIRE,UNIONE CIVILE ,4,2,6
2,2022,Residenti,CITTADINANZA,1771,1441,3212
2,2022,Residenti,CONTESTUALE,41677,40138,81815
2,2022,Residenti,CONTRATTO CONVIVENZA,11,9,20
2,2022,Residenti,ESISTENZA IN VITA,1323,1682,3005
2,2022,Residenti,MATRIMONIO,8485,11214,19699
2,2022,Residenti,NASCITA,10199,11624,21823
2,2022,Residenti,RESIDENZA,32781,42258,75039
2,2022,Residenti,RESIDENZA IN CONVIVENZA,45,41,86
2,2022,Residenti,STATO CIVILE,8716,9661,18377
2,2022,Residenti,STATO FAMIGLIA,37437,48922,86359
2,2022,Residenti,STATO FAMIGLIA CON RAPPORTI PARENTELA,6516,8468,14984
2,2022,Residenti,STATO FAMIGLIA E STATO CIVILE,6626,7881,14507
2,2022,Residenti,STATO LIBERO,5875,4484,10359
2,2022,Residenti,UNIONE CIVILE ,42,39,81
3,2022,AIRE,CITTADINANZA,98,84,182
3,2022,AIRE,CONTESTUALE,345,329,674
3,2022,AIRE,ESISTENZA IN VITA,0,1,1
3,2022,AIRE,MATRIMONIO,99,127,226
3,2022,AIRE,NASCITA,291,288,579
3,2022,AIRE,RESIDENZA,267,335,602
3,2022,AIRE,STATO CIVILE,7,13,20
3,2022,AIRE,STATO FAMIGLIA,185,205,390
3,2022,AIRE,STATO FAMIGLIA CON RAPPORTI PARENTELA,5,0,5
3,2022,AIRE,STATO FAMIGLIA E STATO CIVILE,5,4,9
3,2022,AIRE,STATO LIBERO,4,4,8
3,2022,AIRE,UNIONE CIVILE ,7,1,8
3,2022,Residenti,CITTADINANZA,2087,1405,3492
3,2022,Residenti,CONTESTUALE,46108,42840,88948
3,2022,Residenti,CONTRATTO CONVIVENZA,7,9,16
3,2022,Residenti,ESISTENZA IN VITA,1397,1508,2905
3,2022,Residenti,MATRIMONIO,9398,12218,21616
3,2022,Residenti,NASCITA,11122,12273,23395
3,2022,Residenti,RESIDENZA,37376,46414,83790
3,2022,Residenti,RESIDENZA IN CONVIVENZA,57,44,101
3,2022,Residenti,STATO CIVILE,9845,10096,19941
3,2022,Residenti,STATO FAMIGLIA,36210,46038,82248
3,2022,Residenti,STATO FAMIGLIA CON RAPPORTI PARENTELA,6491,8215,14706
3,2022,Residenti,STATO FAMIGLIA E STATO CIVILE,6727,7661,14388
3,2022,Residenti,STATO LIBERO,6607,5062,11669
3,2022,Residenti,UNIONE CIVILE ,40,48,88
4,2022,AIRE,CITTADINANZA,96,87,183
4,2022,AIRE,CONTESTUALE,346,283,629
4,2022,AIRE,ESISTENZA IN VITA,1,1,2
4,2022,AIRE,MATRIMONIO,71,120,191
4,2022,AIRE,NASCITA,273,228,501
4,2022,AIRE,RESIDENZA,341,448,789
4,2022,AIRE,STATO CIVILE,4,4,8
4,2022,AIRE,STATO FAMIGLIA,160,203,363
4,2022,AIRE,STATO FAMIGLIA CON RAPPORTI PARENTELA,0,5,5
4,2022,AIRE,STATO FAMIGLIA E STATO CIVILE,3,2,5
4,2022,AIRE,STATO LIBERO,1,4,5
4,2022,AIRE,UNIONE CIVILE ,0,2,2
4,2022,Residenti,CITTADINANZA,1640,1203,2843
4,2022,Residenti,CONTESTUALE,36738,34716,71454
4,2022,Residenti,CONTRATTO CONVIVENZA,9,4,13
4,2022,Residenti,ESISTENZA IN VITA,1049,1285,2334
4,2022,Residenti,MATRIMONIO,7535,9512,17047
4,2022,Residenti,NASCITA,9155,9970,19125
4,2022,Residenti,RESIDENZA,32040,39889,71929
4,2022,Residenti,RESIDENZA IN CONVIVENZA,47,45,92
4,2022,Residenti,STATO CIVILE,7779,8349,16128
4,2022,Residenti,STATO FAMIGLIA,27773,34670,62443
4,2022,Residenti,STATO FAMIGLIA CON RAPPORTI PARENTELA,5302,6369,11671
4,2022,Residenti,STATO FAMIGLIA E STATO CIVILE,5328,5971,11299
4,2022,Residenti,STATO LIBERO,5488,4268,9756
4,2022,Residenti,UNIONE CIVILE ,51,36,87
5,2022,AIRE,CITTADINANZA,112,86,198
5,2022,AIRE,CONTESTUALE,394,320,714
5,2022,AIRE,MATRIMONIO,116,138,254
5,2022,AIRE,NASCITA,329,243,572
5,2022,AIRE,RESIDENZA,358,416,774
5,2022,AIRE,STATO CIVILE,8,8,16
5,2022,AIRE,STATO FAMIGLIA,188,189,377
5,2022,AIRE,STATO FAMIGLIA CON RAPPORTI PARENTELA,1,5,6
5,2022,AIRE,STATO FAMIGLIA E STATO CIVILE,3,2,5
5,2022,AIRE,STATO LIBERO,4,3,7
5,2022,AIRE,UNIONE CIVILE ,0,1,1
5,2022,Residenti,CITTADINANZA,1764,1366,3130
5,2022,Residenti,CONTESTUALE,40274,38761,79035
5,2022,Residenti,CONTRATTO CONVIVENZA,19,7,26
5,2022,Residenti,ESISTENZA IN VITA,1171,1377,2548
5,2022,Residenti,MATRIMONIO,8364,11035,19399
5,2022,Residenti,NASCITA,9861,11377,21238
5,2022,Residenti,RESIDENZA,38592,46658,85250
5,2022,Residenti,RESIDENZA IN CONVIVENZA,43,51,94
5,2022,Residenti,STATO CIVILE,9319,9929,19248
5,2022,Residenti,STATO FAMIGLIA,33247,41436,74683
5,2022,Residenti,STATO FAMIGLIA CON RAPPORTI PARENTELA,5995,7389,13384
5,2022,Residenti,STATO FAMIGLIA E STATO CIVILE,6023,6934,12957
5,2022,Residenti,STATO LIBERO,6297,4988,11285
5,2022,Residenti,UNIONE CIVILE ,38,33,71
6,2022,AIRE,CITTADINANZA,123,82,205
6,2022,AIRE,CONTESTUALE,320,257,577
6,2022,AIRE,MATRIMONIO,85,101,186
6,2022,AIRE,NASCITA,284,226,510
6,2022,AIRE,RESIDENZA,291,380,671
6,2022,AIRE,STATO CIVILE,6,6,12
6,2022,AIRE,STATO FAMIGLIA,175,209,384
6,2022,AIRE,STATO FAMIGLIA CON RAPPORTI PARENTELA,2,5,7
6,2022,AIRE,STATO FAMIGLIA E STATO CIVILE,2,1,3
6,2022,AIRE,STATO LIBERO,4,2,6
6,2022,AIRE,UNIONE CIVILE ,1,0,1
6,2022,Residenti,CITTADINANZA,1799,1390,3189
6,2022,Residenti,CONTESTUALE,36965,37010,73975
6,2022,Residenti,CONTRATTO CONVIVENZA,17,6,23
6,2022,Residenti,ESISTENZA IN VITA,1081,1377,2458
6,2022,Residenti,MATRIMONIO,8431,10562,18993
6,2022,Residenti,NASCITA,9161,10056,19217
6,2022,Residenti,RESIDENZA,35240,43615,78855
6,2022,Residenti,RESIDENZA IN CONVIVENZA,39,44,83
6,2022,Residenti,STATO CIVILE,8924,9557,18481
6,2022,Residenti,STATO FAMIGLIA,30444,38068,68512
6,2022,Residenti,STATO FAMIGLIA CON RAPPORTI PARENTELA,5606,6724,12330
6,2022,Residenti,STATO FAMIGLIA E STATO CIVILE,5332,6399,11731
6,2022,Residenti,STATO LIBERO,5698,4747,10445
6,2022,Residenti,UNIONE CIVILE ,41,40,81
7,2022,AIRE,CITTADINANZA,94,76,170
7,2022,AIRE,CONTESTUALE,300,260,560
7,2022,AIRE,ESISTENZA IN VITA,2,0,2
7,2022,AIRE,MATRIMONIO,109,121,230
7,2022,AIRE,NASCITA,264,223,487
7,2022,AIRE,RESIDENZA,320,366,686
7,2022,AIRE,STATO CIVILE,6,6,12
7,2022,AIRE,STATO FAMIGLIA,182,188,370
7,2022,AIRE,STATO FAMIGLIA CON RAPPORTI PARENTELA,1,1,2
7,2022,AIRE,STATO FAMIGLIA E STATO CIVILE,1,2,3
7,2022,AIRE,STATO LIBERO,1,0,1
7,2022,AIRE,UNIONE CIVILE ,2,0,2
7,2022,Residenti,CITTADINANZA,1550,1187,2737
7,2022,Residenti,CONTESTUALE,31993,44433,76426
7,2022,Residenti,CONTRATTO CONVIVENZA,15,16,31
7,2022,Residenti,ESISTENZA IN VITA,1043,1299,2342
7,2022,Residenti,MATRIMONIO,8067,9855,17922
7,2022,Residenti,NASCITA,8592,9659,18251
7,2022,Residenti,RESIDENZA,32551,40575,73126
7,2022,Residenti,RESIDENZA IN CONVIVENZA,40,29,69
7,2022,Residenti,STATO CIVILE,7905,8464,16369
7,2022,Residenti,STATO FAMIGLIA,27218,36967,64185
7,2022,Residenti,STATO FAMIGLIA CON RAPPORTI PARENTELA,5205,6554,11759
7,2022,Residenti,STATO FAMIGLIA E STATO CIVILE,4966,5553,10519
7,2022,Residenti,STATO LIBERO,4874,4116,8990
7,2022,Residenti,UNIONE CIVILE ,52,50,102
8,2022,AIRE,CITTADINANZA,104,69,173
8,2022,AIRE,CONTESTUALE,331,271,602
8,2022,AIRE,ESISTENZA IN VITA,2,0,2
8,2022,AIRE,MATRIMONIO,87,87,174
8,2022,AIRE,NASCITA,338,271,609
8,2022,AIRE,RESIDENZA,315,364,679
8,2022,AIRE,STATO CIVILE,5,1,6
8,2022,AIRE,STATO FAMIGLIA,175,179,354
8,2022,AIRE,STATO FAMIGLIA CON RAPPORTI PARENTELA,7,4,11
8,2022,AIRE,STATO FAMIGLIA E STATO CIVILE,1,1,2
8,2022,AIRE,STATO LIBERO,2,0,2
8,2022,AIRE,UNIONE CIVILE ,0,3,3
8,2022,Residenti,CITTADINANZA,1381,1022,2403
8,2022,Residenti,CONTESTUALE,24088,35079,59167
8,2022,Residenti,CONTRATTO CONVIVENZA,13,11,24
8,2022,Residenti,ESISTENZA IN VITA,799,962,1761
8,2022,Residenti,MATRIMONIO,5387,5995,11382
8,2022,Residenti,NASCITA,7908,8470,16378
8,2022,Residenti,RESIDENZA,27583,33877,61460
8,2022,Residenti,RESIDENZA IN CONVIVENZA,25,40,65
8,2022,Residenti,STATO CIVILE,4634,5117,9751
8,2022,Residenti,STATO FAMIGLIA,21733,29612,51345
8,2022,Residenti,STATO FAMIGLIA CON RAPPORTI PARENTELA,4241,5402,9643
8,2022,Residenti,STATO FAMIGLIA E STATO CIVILE,3426,4095,7521
8,2022,Residenti,STATO LIBERO,2327,1883,4210
8,2022,Residenti,UNIONE CIVILE ,32,35,67
9,2022,AIRE,CITTADINANZA,127,62,189
9,2022,AIRE,CONTESTUALE,330,289,619
9,2022,AIRE,ESISTENZA IN VITA,3,4,7
9,2022,AIRE,MATRIMONIO,118,123,241
9,2022,AIRE,NASCITA,301,276,577
9,2022,AIRE,RESIDENZA,297,403,700
9,2022,AIRE,STATO CIVILE,10,5,15
9,2022,AIRE,STATO FAMIGLIA,187,196,383
9,2022,AIRE,STATO FAMIGLIA CON RAPPORTI PARENTELA,7,3,10
9,2022,AIRE,STATO FAMIGLIA E STATO CIVILE,3,0,3
9,2022,AIRE,STATO LIBERO,3,4,7
9,2022,Residenti,CITTADINANZA,2250,1875,4125
9,2022,Residenti,CONTESTUALE,42830,85841,128671
9,2022,Residenti,CONTRATTO CONVIVENZA,11,21,32
9,2022,Residenti,ESISTENZA IN VITA,1358,1396,2754
9,2022,Residenti,MATRIMONIO,9560,12016,21576
9,2022,Residenti,NASCITA,10996,14301,25297
9,2022,Residenti,RESIDENZA,40613,53430,94043
9,2022,Residenti,RESIDENZA IN CONVIVENZA,53,59,112
9,2022,Residenti,STATO CIVILE,9352,10141,19493
9,2022,Residenti,STATO FAMIGLIA,35162,55497,90659
9,2022,Residenti,STATO FAMIGLIA CON RAPPORTI PARENTELA,6477,8540,15017
9,2022,Residenti,STATO FAMIGLIA E STATO CIVILE,5687,6983,12670
9,2022,Residenti,STATO LIBERO,5631,4877,10508
9,2022,Residenti,UNIONE CIVILE ,46,62,108
10,2022,AIRE,CITTADINANZA,121,73,194
10,2022,AIRE,CONTESTUALE,344,317,661
10,2022,AIRE,ESISTENZA IN VITA,1,0,1
10,2022,AIRE,MATRIMONIO,111,114,225
10,2022,AIRE,NASCITA,336,269,605
10,2022,AIRE,RESIDENZA,353,387,740
10,2022,AIRE,STATO CIVILE,13,6,19
10,2022,AIRE,STATO FAMIGLIA,197,207,404
10,2022,AIRE,STATO FAMIGLIA CON RAPPORTI PARENTELA,7,5,12
10,2022,AIRE,STATO FAMIGLIA E STATO CIVILE,5,3,8
10,2022,AIRE,STATO LIBERO,6,5,11
10,2022,Residenti,CITTADINANZA,2086,1746,3832
10,2022,Residenti,CONTESTUALE,42100,68102,110202
10,2022,Residenti,CONTRATTO CONVIVENZA,14,17,31
10,2022,Residenti,ESISTENZA IN VITA,1289,1428,2717
10,2022,Residenti,MATRIMONIO,9494,11652,21146
10,2022,Residenti,NASCITA,10288,12904,23192
10,2022,Residenti,RESIDENZA,40349,52442,92791
10,2022,Residenti,RESIDENZA IN CONVIVENZA,50,50,100
10,2022,Residenti,STATO CIVILE,9048,9898,18946
10,2022,Residenti,STATO FAMIGLIA,35779,50428,86207
10,2022,Residenti,STATO FAMIGLIA CON RAPPORTI PARENTELA,6606,8440,15046
10,2022,Residenti,STATO FAMIGLIA E STATO CIVILE,6136,7372,13508
10,2022,Residenti,STATO LIBERO,5075,4548,9623
10,2022,Residenti,UNIONE CIVILE ,54,48,102
11,2022,AIRE,CITTADINANZA,145,66,211
11,2022,AIRE,CONTESTUALE,381,335,716
11,2022,AIRE,ESISTENZA IN VITA,2,1,3
11,2022,AIRE,MATRIMONIO,118,123,241
11,2022,AIRE,NASCITA,353,270,623
11,2022,AIRE,RESIDENZA,349,344,693
11,2022,AIRE,STATO CIVILE,9,3,12
11,2022,AIRE,STATO FAMIGLIA,204,197,401
11,2022,AIRE,STATO FAMIGLIA CON RAPPORTI PARENTELA,3,2,5
11,2022,AIRE,STATO FAMIGLIA E STATO CIVILE,4,6,10
11,2022,AIRE,STATO LIBERO,1,2,3
11,2022,AIRE,UNIONE CIVILE ,0,1,1
11,2022,Residenti,CITTADINANZA,2259,1692,3951
11,2022,Residenti,CONTESTUALE,40156,50166,90322
11,2022,Residenti,CONTRATTO CONVIVENZA,17,8,25
11,2022,Residenti,ESISTENZA IN VITA,1410,1599,3009
11,2022,Residenti,MATRIMONIO,8825,11591,20416
11,2022,Residenti,NASCITA,10369,11897,22266
11,2022,Residenti,RESIDENZA,39652,48726,88378
11,2022,Residenti,RESIDENZA IN CONVIVENZA,50,48,98
11,2022,Residenti,STATO CIVILE,9668,10225,19893
11,2022,Residenti,STATO FAMIGLIA,33615,45352,78967
11,2022,Residenti,STATO FAMIGLIA CON RAPPORTI PARENTELA,6875,8578,15453
11,2022,Residenti,STATO FAMIGLIA E STATO CIVILE,5979,6981,12960
11,2022,Residenti,STATO LIBERO,5499,4985,10484
11,2022,Residenti,UNIONE CIVILE ,62,37,99
12,2022,AIRE,CITTADINANZA,168,59,227
12,2022,AIRE,CONTESTUALE,432,310,742
12,2022,AIRE,ESISTENZA IN VITA,1,1,2
12,2022,AIRE,MATRIMONIO,110,113,223
12,2022,AIRE,NASCITA,323,244,567
12,2022,AIRE,RESIDENZA,441,368,809
12,2022,AIRE,STATO CIVILE,8,5,13
12,2022,AIRE,STATO FAMIGLIA,241,186,427
12,2022,AIRE,STATO FAMIGLIA CON RAPPORTI PARENTELA,4,3,7
12,2022,AIRE,STATO FAMIGLIA E STATO CIVILE,2,2,4
12,2022,AIRE,STATO LIBERO,2,1,3
12,2022,AIRE,UNIONE CIVILE ,1,0,1
12,2022,Residenti,CITTADINANZA,2678,1381,4059
12,2022,Residenti,CONTESTUALE,34641,34588,69229
12,2022,Residenti,CONTRATTO CONVIVENZA,18,9,27
12,2022,Residenti,ESISTENZA IN VITA,1954,1535,3489
12,2022,Residenti,MATRIMONIO,7292,8388,15680
12,2022,Residenti,NASCITA,9746,9085,18831
12,2022,Residenti,RESIDENZA,35122,40043,75165
12,2022,Residenti,RESIDENZA IN CONVIVENZA,44,52,96
12,2022,Residenti,STATO CIVILE,8353,7920,16273
12,2022,Residenti,STATO FAMIGLIA,29660,35102,64762
12,2022,Residenti,STATO FAMIGLIA CON RAPPORTI PARENTELA,6626,6767,13393
12,2022,Residenti,STATO FAMIGLIA E STATO CIVILE,5832,5354,11186
12,2022,Residenti,STATO LIBERO,4851,3378,8229
12,2022,Residenti,UNIONE CIVILE ,42,35,77
1,2023,AIRE,CITTADINANZA,13,187,200
1,2023,AIRE,CONTESTUALE,38,823,861
1,2023,AIRE,ESISTENZA IN VITA,0,4,4
1,2023,AIRE,MATRIMONIO,14,221,235
1,2023,AIRE,NASCITA,29,572,601
1,2023,AIRE,RESIDENZA,35,896,931
1,2023,AIRE,STATO CIVILE,2,21,23
1,2023,AIRE,STATO FAMIGLIA,23,415,438
1,2023,AIRE,STATO FAMIGLIA CON RAPPORTI PARENTELA,0,11,11
1,2023,AIRE,STATO FAMIGLIA E STATO CIVILE,0,6,6
1,2023,AIRE,STATO LIBERO,1,10,11
1,2023,AIRE,UNIONE CIVILE ,0,2,2
1,2023,Residenti,CITTADINANZA,136,3170,3306
1,2023,Residenti,CONTESTUALE,2289,90066,92355
1,2023,Residenti,CONTRATTO CONVIVENZA,0,26,26
1,2023,Residenti,ESISTENZA IN VITA,104,2996,3100
1,2023,Residenti,MATRIMONIO,408,17709,18117
1,2023,Residenti,NASCITA,711,22000,22711
1,2023,Residenti,RESIDENZA,2468,93793,96261
1,2023,Residenti,RESIDENZA IN CONVIVENZA,4,116,120
1,2023,Residenti,STATO CIVILE,439,17617,18056
1,2023,Residenti,STATO FAMIGLIA,3223,117391,120614
1,2023,Residenti,STATO FAMIGLIA CON RAPPORTI PARENTELA,463,18712,19175
1,2023,Residenti,STATO FAMIGLIA E STATO CIVILE,454,15315,15769
1,2023,Residenti,STATO LIBERO,212,7719,7931
1,2023,Residenti,UNIONE CIVILE ,2,76,78
2,2023,AIRE,CITTADINANZA,0,183,183
2,2023,AIRE,CONTESTUALE,0,733,733
2,2023,AIRE,ESISTENZA IN VITA,0,2,2
2,2023,AIRE,MATRIMONIO,0,232,232
2,2023,AIRE,NASCITA,0,597,597
2,2023,AIRE,RESIDENZA,0,753,753
2,2023,AIRE,STATO CIVILE,0,20,20
2,2023,AIRE,STATO FAMIGLIA,0,410,410
2,2023,AIRE,STATO FAMIGLIA CON RAPPORTI PARENTELA,0,11,11
2,2023,AIRE,STATO FAMIGLIA E STATO CIVILE,0,11,11
2,2023,AIRE,STATO LIBERO,0,10,10
2,2023,AIRE,UNIONE CIVILE ,0,6,6
2,2023,Residenti,CITTADINANZA,0,2962,2962
2,2023,Residenti,CONTESTUALE,0,86201,86201
2,2023,Residenti,CONTRATTO CONVIVENZA,0,18,18
2,2023,Residenti,ESISTENZA IN VITA,0,2287,2287
2,2023,Residenti,MATRIMONIO,0,18135,18135
2,2023,Residenti,NASCITA,0,19854,19854
2,2023,Residenti,RESIDENZA,0,87875,87875
2,2023,Residenti,RESIDENZA IN CONVIVENZA,0,106,106
2,2023,Residenti,STATO CIVILE,0,17801,17801
2,2023,Residenti,STATO FAMIGLIA,0,88359,88359
2,2023,Residenti,STATO FAMIGLIA CON RAPPORTI PARENTELA,0,14597,14597
2,2023,Residenti,STATO FAMIGLIA E STATO CIVILE,0,12991,12991
2,2023,Residenti,STATO LIBERO,0,8330,8330
2,2023,Residenti,UNIONE CIVILE ,0,79,79
3,2023,AIRE,CITTADINANZA,0,186,186
3,2023,AIRE,CONTESTUALE,0,761,761
3,2023,AIRE,ESISTENZA IN VITA,0,6,6
3,2023,AIRE,MATRIMONIO,0,284,284
3,2023,AIRE,NASCITA,0,561,561
3,2023,AIRE,RESIDENZA,0,893,893
3,2023,AIRE,STATO CIVILE,0,19,19
3,2023,AIRE,STATO FAMIGLIA,0,391,391
3,2023,AIRE,STATO FAMIGLIA CON RAPPORTI PARENTELA,0,14,14
3,2023,AIRE,STATO FAMIGLIA E STATO CIVILE,0,8,8
3,2023,AIRE,STATO LIBERO,0,8,8
3,2023,AIRE,UNIONE CIVILE ,0,2,2
3,2023,Residenti,CITTADINANZA,0,2956,2956
3,2023,Residenti,CONTESTUALE,0,85705,85705
3,2023,Residenti,CONTRATTO CONVIVENZA,0,23,23
3,2023,Residenti,ESISTENZA IN VITA,0,2344,2344
3,2023,Residenti,MATRIMONIO,0,17003,17003
3,2023,Residenti,NASCITA,0,19895,19895
3,2023,Residenti,RESIDENZA,0,88529,88529
3,2023,Residenti,RESIDENZA IN CONVIVENZA,0,101,101
3,2023,Residenti,STATO CIVILE,0,17276,17276
3,2023,Residenti,STATO FAMIGLIA,0,77935,77935
3,2023,Residenti,STATO FAMIGLIA CON RAPPORTI PARENTELA,0,13166,13166
3,2023,Residenti,STATO FAMIGLIA E STATO CIVILE,0,11759,11759
3,2023,Residenti,STATO LIBERO,0,7660,7660
3,2023,Residenti,UNIONE CIVILE ,0,81,81
4,2023,AIRE,CITTADINANZA,0,155,155
4,2023,AIRE,CONTESTUALE,0,621,621
4,2023,AIRE,ESISTENZA IN VITA,0,4,4
4,2023,AIRE,MATRIMONIO,0,189,189
4,2023,AIRE,NASCITA,0,441,441
4,2023,AIRE,RESIDENZA,0,698,698
4,2023,AIRE,STATO CIVILE,0,15,15
4,2023,AIRE,STATO FAMIGLIA,0,326,326
4,2023,AIRE,STATO FAMIGLIA CON RAPPORTI PARENTELA,0,4,4
4,2023,AIRE,STATO FAMIGLIA E STATO CIVILE,0,4,4
4,2023,AIRE,STATO LIBERO,0,6,6
4,2023,AIRE,UNIONE CIVILE ,0,3,3
4,2023,Residenti,CITTADINANZA,0,2346,2346
4,2023,Residenti,CONTESTUALE,0,63584,63584
4,2023,Residenti,CONTRATTO CONVIVENZA,0,13,13
4,2023,Residenti,ESISTENZA IN VITA,0,1626,1626
4,2023,Residenti,MATRIMONIO,0,11893,11893
4,2023,Residenti,NASCITA,0,14550,14550
4,2023,Residenti,RESIDENZA,0,69035,69035
4,2023,Residenti,RESIDENZA IN CONVIVENZA,0,88,88
4,2023,Residenti,STATO CIVILE,0,12478,12478
4,2023,Residenti,STATO FAMIGLIA,0,54490,54490
4,2023,Residenti,STATO FAMIGLIA CON RAPPORTI PARENTELA,0,9421,9421
4,2023,Residenti,STATO FAMIGLIA E STATO CIVILE,0,8586,8586
4,2023,Residenti,STATO LIBERO,0,5507,5507
4,2023,Residenti,UNIONE CIVILE ,0,63,63
5,2023,AIRE,CITTADINANZA,0,139,139
5,2023,AIRE,CONTESTUALE,0,615,615
5,2023,AIRE,ESISTENZA IN VITA,0,4,4
5,2023,AIRE,MATRIMONIO,0,238,238
5,2023,AIRE,NASCITA,0,442,442
5,2023,AIRE,RESIDENZA,0,787,787
5,2023,AIRE,STATO CIVILE,0,16,16
5,2023,AIRE,STATO FAMIGLIA,0,372,372
5,2023,AIRE,STATO FAMIGLIA CON RAPPORTI PARENTELA,0,8,8
5,2023,AIRE,STATO FAMIGLIA E STATO CIVILE,0,11,11
5,2023,AIRE,STATO LIBERO,0,8,8
5,2023,AIRE,UNIONE CIVILE ,0,4,4
5,2023,Residenti,CITTADINANZA,0,2759,2759
5,2023,Residenti,CONTESTUALE,0,78277,78277
5,2023,Residenti,CONTRATTO CONVIVENZA,0,14,14
5,2023,Residenti,ESISTENZA IN VITA,0,1959,1959
5,2023,Residenti,MATRIMONIO,0,16011,16011
5,2023,Residenti,NASCITA,0,17407,17407
5,2023,Residenti,RESIDENZA,0,84699,84699
5,2023,Residenti,RESIDENZA IN CONVIVENZA,0,118,118
5,2023,Residenti,STATO CIVILE,0,15936,15936
5,2023,Residenti,STATO FAMIGLIA,0,65958,65958
5,2023,Residenti,STATO FAMIGLIA CON RAPPORTI PARENTELA,0,11085,11085
5,2023,Residenti,STATO FAMIGLIA E STATO CIVILE,0,10369,10369
5,2023,Residenti,STATO LIBERO,0,6470,6470
5,2023,Residenti,UNIONE CIVILE ,0,95,95
6,2023,AIRE,CITTADINANZA,0,121,121
6,2023,AIRE,CONTESTUALE,0,581,581
6,2023,AIRE,ESISTENZA IN VITA,0,3,3
6,2023,AIRE,MATRIMONIO,0,179,179
6,2023,AIRE,NASCITA,0,459,459
6,2023,AIRE,RESIDENZA,0,754,754
6,2023,AIRE,STATO CIVILE,0,10,10
6,2023,AIRE,STATO FAMIGLIA,0,309,309
6,2023,AIRE,STATO FAMIGLIA CON RAPPORTI PARENTELA,0,3,3
6,2023,AIRE,STATO FAMIGLIA E STATO CIVILE,0,3,3
6,2023,AIRE,STATO LIBERO,0,6,6
6,2023,Residenti,CITTADINANZA,0,2485,2485
6,2023,Residenti,CONTESTUALE,0,67636,67636
6,2023,Residenti,CONTRATTO CONVIVENZA,0,11,11
6,2023,Residenti,ESISTENZA IN VITA,0,2082,2082
6,2023,Residenti,MATRIMONIO,0,14681,14681
6,2023,Residenti,NASCITA,0,15888,15888
6,2023,Residenti,RESIDENZA,0,75545,75545
6,2023,Residenti,RESIDENZA IN CONVIVENZA,0,85,85
6,2023,Residenti,STATO CIVILE,0,13708,13708
6,2023,Residenti,STATO FAMIGLIA,0,59952,59952
6,2023,Residenti,STATO FAMIGLIA CON RAPPORTI PARENTELA,0,10307,10307
6,2023,Residenti,STATO FAMIGLIA E STATO CIVILE,0,9033,9033
6,2023,Residenti,STATO LIBERO,0,5752,5752
6,2023,Residenti,UNIONE CIVILE ,0,70,70
7,2023,AIRE,CITTADINANZA,0,149,149
7,2023,AIRE,CONTESTUALE,0,597,597
7,2023,AIRE,ESISTENZA IN VITA,0,3,3
7,2023,AIRE,MATRIMONIO,0,193,193
7,2023,AIRE,NASCITA,0,473,473
7,2023,AIRE,RESIDENZA,0,644,644
7,2023,AIRE,STATO CIVILE,0,13,13
7,2023,AIRE,STATO FAMIGLIA,0,304,304
7,2023,AIRE,STATO FAMIGLIA CON RAPPORTI PARENTELA,0,5,5
7,2023,AIRE,STATO FAMIGLIA E STATO CIVILE,0,3,3
7,2023,AIRE,STATO LIBERO,0,6,6
7,2023,AIRE,UNIONE CIVILE ,0,6,6
7,2023,Residenti,CITTADINANZA,0,2203,2203
7,2023,Residenti,CONTESTUALE,0,83794,83794
7,2023,Residenti,CONTRATTO CONVIVENZA,0,16,16
7,2023,Residenti,ESISTENZA IN VITA,0,1835,1835
7,2023,Residenti,MATRIMONIO,0,14339,14339
7,2023,Residenti,NASCITA,0,16026,16026
7,2023,Residenti,RESIDENZA,0,73442,73442
7,2023,Residenti,RESIDENZA IN CONVIVENZA,0,90,90
7,2023,Residenti,STATO CIVILE,0,12768,12768
7,2023,Residenti,STATO FAMIGLIA,0,64306,64306
7,2023,Residenti,STATO FAMIGLIA CON RAPPORTI PARENTELA,0,10550,10550
7,2023,Residenti,STATO FAMIGLIA E STATO CIVILE,0,8314,8314
7,2023,Residenti,STATO LIBERO,0,5151,5151
7,2023,Residenti,UNIONE CIVILE ,0,97,97
8,2023,AIRE,CITTADINANZA,9,86,95
8,2023,AIRE,CONTESTUALE,61,373,434
8,2023,AIRE,MATRIMONIO,23,139,162
8,2023,AIRE,NASCITA,94,324,418
8,2023,AIRE,RESIDENZA,100,467,567
8,2023,AIRE,STATO CIVILE,2,8,10
8,2023,AIRE,STATO FAMIGLIA,22,203,225
8,2023,AIRE,STATO FAMIGLIA CON RAPPORTI PARENTELA,1,2,3
8,2023,AIRE,STATO FAMIGLIA E STATO CIVILE,0,1,1
8,2023,AIRE,STATO LIBERO,2,1,3
8,2023,AIRE,UNIONE CIVILE ,1,1,2
8,2023,Residenti,CITTADINANZA,69,1771,1840
8,2023,Residenti,CONTESTUALE,5209,61018,66227
8,2023,Residenti,CONTRATTO CONVIVENZA,3,13,16
8,2023,Residenti,ESISTENZA IN VITA,90,1037,1127
8,2023,Residenti,MATRIMONIO,745,7646,8391
8,2023,Residenti,NASCITA,1166,11391,12557
8,2023,Residenti,RESIDENZA,3280,52706,55986
8,2023,Residenti,RESIDENZA IN CONVIVENZA,1,57,58
8,2023,Residenti,STATO CIVILE,692,6591,7283
8,2023,Residenti,STATO FAMIGLIA,3372,43441,46813
8,2023,Residenti,STATO FAMIGLIA CON RAPPORTI PARENTELA,502,7209,7711
8,2023,Residenti,STATO FAMIGLIA E STATO CIVILE,417,5582,5999
8,2023,Residenti,STATO LIBERO,768,2108,2876
8,2023,Residenti,UNIONE CIVILE ,10,49,59
9,2023,AIRE,CITTADINANZA,11,103,114
9,2023,AIRE,CONTESTUALE,89,413,502
9,2023,AIRE,ESISTENZA IN VITA,0,1,1
9,2023,AIRE,MATRIMONIO,29,178,207
9,2023,AIRE,NASCITA,131,270,401
9,2023,AIRE,RESIDENZA,122,508,630
9,2023,AIRE,STATO CIVILE,1,7,8
9,2023,AIRE,STATO FAMIGLIA,37,237,274
9,2023,AIRE,STATO FAMIGLIA CON RAPPORTI PARENTELA,0,6,6
9,2023,AIRE,STATO FAMIGLIA E STATO CIVILE,0,7,7
9,2023,AIRE,STATO LIBERO,3,7,10
9,2023,AIRE,UNIONE CIVILE ,1,0,1
9,2023,Residenti,CITTADINANZA,104,2184,2288
9,2023,Residenti,CONTESTUALE,9129,133583,142712
9,2023,Residenti,CONTRATTO CONVIVENZA,1,9,10
9,2023,Residenti,ESISTENZA IN VITA,148,1533,1681
9,2023,Residenti,MATRIMONIO,1602,13140,14742
9,2023,Residenti,NASCITA,1651,17422,19073
9,2023,Residenti,RESIDENZA,5167,73768,78935
9,2023,Residenti,RESIDENZA IN CONVIVENZA,2,76,78
9,2023,Residenti,STATO CIVILE,2008,12159,14167
9,2023,Residenti,STATO FAMIGLIA,5682,73222,78904
9,2023,Residenti,STATO FAMIGLIA CON RAPPORTI PARENTELA,721,10996,11717
9,2023,Residenti,STATO FAMIGLIA E STATO CIVILE,789,9021,9810
9,2023,Residenti,STATO LIBERO,1925,4384,6309
9,2023,Residenti,UNIONE CIVILE ,13,76,89
10,2023,AIRE,CITTADINANZA,6,99,105
10,2023,AIRE,CONTESTUALE,107,453,560
10,2023,AIRE,ESISTENZA IN VITA,0,2,2
10,2023,AIRE,MATRIMONIO,24,182,206
10,2023,AIRE,NASCITA,96,354,450
10,2023,AIRE,RESIDENZA,124,663,787
10,2023,AIRE,STATO CIVILE,2,8,10
10,2023,AIRE,STATO FAMIGLIA,36,255,291
10,2023,AIRE,STATO FAMIGLIA CON RAPPORTI PARENTELA,0,6,6
10,2023,AIRE,STATO FAMIGLIA E STATO CIVILE,0,4,4
10,2023,AIRE,STATO LIBERO,3,1,4
10,2023,AIRE,UNIONE CIVILE ,0,1,1
10,2023,Residenti,CITTADINANZA,127,2357,2484
10,2023,Residenti,CONTESTUALE,10174,103180,113354
10,2023,Residenti,CONTRATTO CONVIVENZA,3,16,19
10,2023,Residenti,ESISTENZA IN VITA,181,1815,1996
10,2023,Residenti,MATRIMONIO,1658,14720,16378
10,2023,Residenti,NASCITA,1524,16878,18402
10,2023,Residenti,RESIDENZA,5587,76148,81735
10,2023,Residenti,RESIDENZA IN CONVIVENZA,5,95,100
10,2023,Residenti,STATO CIVILE,2150,12687,14837
10,2023,Residenti,STATO FAMIGLIA,5659,68667,74326
10,2023,Residenti,STATO FAMIGLIA CON RAPPORTI PARENTELA,774,10947,11721
10,2023,Residenti,STATO FAMIGLIA E STATO CIVILE,905,9513,10418
10,2023,Residenti,STATO LIBERO,2132,4548,6680
10,2023,Residenti,UNIONE CIVILE ,9,73,82
11,2023,AIRE,CITTADINANZA,7,108,115
11,2023,AIRE,CONTESTUALE,99,435,534
11,2023,AIRE,MATRIMONIO,20,166,186
11,2023,AIRE,NASCITA,133,303,436
11,2023,AIRE,RESIDENZA,123,598,721
11,2023,AIRE,STATO CIVILE,3,5,8
11,2023,AIRE,STATO FAMIGLIA,28,242,270
11,2023,AIRE,STATO FAMIGLIA CON RAPPORTI PARENTELA,0,5,5
11,2023,AIRE,STATO LIBERO,1,2,3
11,2023,Residenti,CITTADINANZA,92,1965,2057
11,2023,Residenti,CONTESTUALE,9613,69630,79243
11,2023,Residenti,CONTRATTO CONVIVENZA,1,10,11
11,2023,Residenti,ESISTENZA IN VITA,177,1817,1994
11,2023,Residenti,MATRIMONIO,1390,13319,14709
11,2023,Residenti,NASCITA,1439,14162,15601
11,2023,Residenti,RESIDENZA,4964,70181,75145
11,2023,Residenti,RESIDENZA IN CONVIVENZA,1,66,67
11,2023,Residenti,STATO CIVILE,2107,11989,14096
11,2023,Residenti,STATO FAMIGLIA,5475,60595,66070
11,2023,Residenti,STATO FAMIGLIA CON RAPPORTI PARENTELA,771,10644,11415
11,2023,Residenti,STATO FAMIGLIA E STATO CIVILE,818,8703,9521
11,2023,Residenti,STATO LIBERO,2405,4896,7301
11,2023,Residenti,UNIONE CIVILE ,21,69,90
12,2023,AIRE,CITTADINANZA,16,87,103
12,2023,AIRE,CONTESTUALE,109,421,530
12,2023,AIRE,ESISTENZA IN VITA,0,2,2
12,2023,AIRE,MATRIMONIO,24,146,170
12,2023,AIRE,NASCITA,100,273,373
12,2023,AIRE,RESIDENZA,85,606,691
12,2023,AIRE,STATO CIVILE,1,6,7
12,2023,AIRE,STATO FAMIGLIA,23,220,243
12,2023,AIRE,STATO FAMIGLIA CON RAPPORTI PARENTELA,0,3,3
12,2023,AIRE,STATO FAMIGLIA E STATO CIVILE,0,1,1
12,2023,AIRE,STATO LIBERO,1,0,1
12,2023,AIRE,UNIONE CIVILE ,1,0,1
12,2023,Residenti,CITTADINANZA,95,1833,1928
12,2023,Residenti,CONTESTUALE,7665,60100,67765
12,2023,Residenti,CONTRATTO CONVIVENZA,2,10,12
12,2023,Residenti,ESISTENZA IN VITA,166,2268,2434
12,2023,Residenti,MATRIMONIO,997,10985,11982
12,2023,Residenti,NASCITA,1248,12133,13381
12,2023,Residenti,RESIDENZA,4307,125650,129957
12,2023,Residenti,RESIDENZA IN CONVIVENZA,1,68,69
12,2023,Residenti,STATO CIVILE,1615,10016,11631
12,2023,Residenti,STATO FAMIGLIA,4539,50105,54644
12,2023,Residenti,STATO FAMIGLIA CON RAPPORTI PARENTELA,715,8127,8842
12,2023,Residenti,STATO FAMIGLIA E STATO CIVILE,647,6560,7207
12,2023,Residenti,STATO LIBERO,1700,3722,5422
12,2023,Residenti,UNIONE CIVILE ,8,52,60
1,2024,AIRE,CITTADINANZA,14,88,102
1,2024,AIRE,CONTESTUALE,111,537,648
1,2024,AIRE,MATRIMONIO,32,177,209
1,2024,AIRE,NASCITA,178,338,516
1,2024,AIRE,RESIDENZA,140,873,1013
1,2024,AIRE,STATO CIVILE,0,4,4
1,2024,AIRE,STATO FAMIGLIA,32,279,311
1,2024,AIRE,STATO FAMIGLIA CON RAPPORTI PARENTELA,1,3,4
1,2024,AIRE,STATO FAMIGLIA E STATO CIVILE,0,2,2
1,2024,AIRE,STATO LIBERO,0,3,3
1,2024,AIRE,UNIONE CIVILE ,0,2,2
1,2024,Residenti,CITTADINANZA,138,2736,2874
1,2024,Residenti,CONTESTUALE,11918,109134,121052
1,2024,Residenti,CONTRATTO CONVIVENZA,1,23,24
1,2024,Residenti,ESISTENZA IN VITA,211,4536,4747
1,2024,Residenti,MATRIMONIO,1364,17047,18411
1,2024,Residenti,NASCITA,1846,19422,21268
1,2024,Residenti,RESIDENZA,6051,245097,251148
1,2024,Residenti,RESIDENZA IN CONVIVENZA,0,172,172
1,2024,Residenti,STATO CIVILE,2073,16075,18148
1,2024,Residenti,STATO FAMIGLIA,7776,110291,118067
1,2024,Residenti,STATO FAMIGLIA CON RAPPORTI PARENTELA,1118,14369,15487
1,2024,Residenti,STATO FAMIGLIA E STATO CIVILE,1008,11883,12891
1,2024,Residenti,STATO LIBERO,2254,5138,7392
1,2024,Residenti,UNIONE CIVILE ,11,81,92
2,2024,AIRE,CITTADINANZA,13,131,144
2,2024,AIRE,CONTESTUALE,127,476,603
2,2024,AIRE,ESISTENZA IN VITA,0,1,1
2,2024,AIRE,MATRIMONIO,29,152,181
2,2024,AIRE,NASCITA,172,373,545
2,2024,AIRE,RESIDENZA,133,1009,1142
2,2024,AIRE,STATO CIVILE,1,5,6
2,2024,AIRE,STATO FAMIGLIA,22,288,310
2,2024,AIRE,STATO FAMIGLIA CON RAPPORTI PARENTELA,1,6,7
2,2024,AIRE,STATO FAMIGLIA E STATO CIVILE,0,3,3
2,2024,AIRE,STATO LIBERO,1,1,2
2,2024,AIRE,UNIONE CIVILE ,1,1,2
2,2024,Residenti,CITTADINANZA,119,2792,2911
2,2024,Residenti,CONTESTUALE,13345,118316,131661
2,2024,Residenti,CONTRATTO CONVIVENZA,3,20,23
2,2024,Residenti,ESISTENZA IN VITA,181,3888,4069
2,2024,Residenti,MATRIMONIO,1277,18840,20117
2,2024,Residenti,NASCITA,1758,19863,21621
2,2024,Residenti,RESIDENZA,5827,270533,276360
2,2024,Residenti,RESIDENZA IN CONVIVENZA,4,212,216
2,2024,Residenti,STATO CIVILE,2148,17127,19275
2,2024,Residenti,STATO FAMIGLIA,7058,92547,99605
2,2024,Residenti,STATO FAMIGLIA CON RAPPORTI PARENTELA,859,11620,12479
2,2024,Residenti,STATO FAMIGLIA E STATO CIVILE,1036,10537,11573
2,2024,Residenti,STATO LIBERO,2392,5531,7923
2,2024,Residenti,UNIONE CIVILE ,10,91,101