MESE,ANNO,TIPO SOGGETTO,TIPOLOGIA CERTIFICATO,BOLLO,ESENTI DA BOLLO,TOTALE
11,2021,AIRE,CITTADINANZA,296,191,487
11,2021,AIRE,CONTESTUALE,914,814,1728
11,2021,AIRE,ESISTENZA IN VITA,3,0,3
11,2021,AIRE,MATRIMONIO,222,270,492
11,2021,AIRE,NASCITA,448,380,828
11,2021,AIRE,RESIDENZA,648,695,1343
11,2021,AIRE,STATO CIVILE,11,4,15
11,2021,AIRE,STATO FAMIGLIA,364,410,774
11,2021,AIRE,STATO FAMIGLIA CON RAPPORTI PARENTELA,2,0,2
11,2021,AIRE,STATO FAMIGLIA E STATO CIVILE,4,2,6
11,2021,AIRE,STATO LIBERO,3,1,4
11,2021,AIRE,UNIONE CIVILE ,0,4,4
11,2021,Residenti,CITTADINANZA,4969,3810,8779
11,2021,Residenti,CONTESTUALE,52346,54324,106670
11,2021,Residenti,CONTRATTO CONVIVENZA,24,11,35
11,2021,Residenti,ESISTENZA IN VITA,4463,4939,9402
11,2021,Residenti,MATRIMONIO,14115,21302,35417
11,2021,Residenti,NASCITA,21974,29828,51802
11,2021,Residenti,RESIDENZA,40057,51696,91753
11,2021,Residenti,RESIDENZA IN CONVIVENZA,47,63,110
11,2021,Residenti,STATO CIVILE,11070,11852,22922
11,2021,Residenti,STATO FAMIGLIA,35598,48850,84448
11,2021,Residenti,STATO FAMIGLIA CON RAPPORTI PARENTELA,12198,15356,27554
11,2021,Residenti,STATO FAMIGLIA E STATO CIVILE,11152,13995,25147
11,2021,Residenti,STATO LIBERO,5464,3732,9196
11,2021,Residenti,UNIONE CIVILE ,178,158,336
12,2021,AIRE,CITTADINANZA,155,104,259
12,2021,AIRE,CONTESTUALE,450,306,756
12,2021,AIRE,ESISTENZA IN VITA,4,0,4
12,2021,AIRE,MATRIMONIO,177,140,317
12,2021,AIRE,NASCITA,308,242,550
12,2021,AIRE,RESIDENZA,426,400,826
12,2021,AIRE,STATO CIVILE,6,2,8
12,2021,AIRE,STATO FAMIGLIA,230,215,445
12,2021,AIRE,STATO FAMIGLIA CON RAPPORTI PARENTELA,0,2,2
12,2021,AIRE,STATO FAMIGLIA E STATO CIVILE,4,2,6
12,2021,AIRE,STATO LIBERO,2,0,2
12,2021,AIRE,UNIONE CIVILE ,2,3,5
12,2021,Residenti,CITTADINANZA,3230,1403,4633
12,2021,Residenti,CONTESTUALE,35865,30891,66756
12,2021,Residenti,CONTRATTO CONVIVENZA,7,6,13
12,2021,Residenti,ESISTENZA IN VITA,2617,2024,4641
12,2021,Residenti,MATRIMONIO,8806,9431,18237
12,2021,Residenti,NASCITA,12038,11044,23082
12,2021,Residenti,RESIDENZA,31681,35642,67323
12,2021,Residenti,RESIDENZA IN CONVIVENZA,37,30,67
12,2021,Residenti,STATO CIVILE,8767,7205,15972
12,2021,Residenti,STATO FAMIGLIA,29047,33571,62618
12,2021,Residenti,STATO FAMIGLIA CON RAPPORTI PARENTELA,7594,7138,14732
12,2021,Residenti,STATO FAMIGLIA E STATO CIVILE,7126,6229,13355
12,2021,Residenti,STATO LIBERO,5043,3007,8050
12,2021,Residenti,UNIONE CIVILE ,37,39,76
1,2022,AIRE,CITTADINANZA,150,88,238
1,2022,AIRE,CONTESTUALE,375,316,691
1,2022,AIRE,ESISTENZA IN VITA,0,1,1
1,2022,AIRE,MATRIMONIO,112,132,244
1,2022,AIRE,NASCITA,319,279,598
1,2022,AIRE,RESIDENZA,316,335,651
1,2022,AIRE,STATO CIVILE,6,6,12
1,2022,AIRE,STATO FAMIGLIA,188,214,402
1,2022,AIRE,STATO FAMIGLIA CON RAPPORTI PARENTELA,2,2,4
1,2022,AIRE,STATO FAMIGLIA E STATO CIVILE,1,1,2
1,2022,AIRE,STATO LIBERO,5,2,7
1,2022,AIRE,UNIONE CIVILE ,1,2,3
1,2022,Residenti,CITTADINANZA,1749,1566,3315
1,2022,Residenti,CONTESTUALE,39570,39428,78998
1,2022,Residenti,CONTRATTO CONVIVENZA,19,9,28
1,2022,Residenti,ESISTENZA IN VITA,1682,2247,3929
1,2022,Residenti,MATRIMONIO,8089,10955,19044
1,2022,Residenti,NASCITA,11234,12612,23846
1,2022,Residenti,RESIDENZA,36024,47576,83600
1,2022,Residenti,RESIDENZA IN CONVIVENZA,46,41,87
1,2022,Residenti,STATO CIVILE,8081,8846,16927
1,2022,Residenti,STATO FAMIGLIA,47616,61258,108874
1,2022,Residenti,STATO FAMIGLIA CON RAPPORTI PARENTELA,8204,10508,18712
1,2022,Residenti,STATO FAMIGLIA E STATO CIVILE,7430,8965,16395
1,2022,Residenti,STATO LIBERO,5083,3633,8716
1,2022,Residenti,UNIONE CIVILE ,35,40,75
2,2022,AIRE,CITTADINANZA,102,76,178
2,2022,AIRE,CONTESTUALE,330,330,660
2,2022,AIRE,ESISTENZA IN VITA,1,1,2
2,2022,AIRE,MATRIMONIO,105,135,240
2,2022,AIRE,NASCITA,302,248,550
2,2022,AIRE,RESIDENZA,319,339,658
2,2022,AIRE,STATO CIVILE,1,7,8
2,2022,AIRE,STATO FAMIGLIA,187,189,376
2,2022,AIRE,STATO FAMIGLIA CON RAPPORTI PARENTELA,0,5,5
2,2022,AIRE,STATO FAMIGLIA E STATO CIVILE,2,3,5
2,2022,AIRE,STATO LIBERO,0,1,1
2,2022,AIRE,UNIONE CIVILE ,4,2,6
2,2022,Residenti,CITTADINANZA,1771,1441,3212
2,2022,Residenti,CONTESTUALE,41677,40138,81815
2,2022,Residenti,CONTRATTO CONVIVENZA,11,9,20
2,2022,Residenti,ESISTENZA IN VITA,1324,1682,3006
2,2022,Residenti,MATRIMONIO,8486,11214,19700
2,2022,Residenti,NASCITA,10200,11624,21824
2,2022,Residenti,RESIDENZA,32782,42259,75041
2,2022,Residenti,RESIDENZA IN CONVIVENZA,45,41,86
2,2022,Residenti,STATO CIVILE,8717,9661,18378
2,2022,Residenti,STATO FAMIGLIA,37438,48922,86360
2,2022,Residenti,STATO FAMIGLIA CON RAPPORTI PARENTELA,6517,8468,14985
2,2022,Residenti,STATO FAMIGLIA E STATO CIVILE,6627,7881,14508
2,2022,Residenti,STATO LIBERO,5875,4484,10359
2,2022,Residenti,UNIONE CIVILE ,42,39,81
3,2022,AIRE,CITTADINANZA,98,84,182
3,2022,AIRE,CONTESTUALE,345,329,674
3,2022,AIRE,ESISTENZA IN VITA,0,1,1
3,2022,AIRE,MATRIMONIO,99,127,226
3,2022,AIRE,NASCITA,291,288,579
3,2022,AIRE,RESIDENZA,267,335,602
3,2022,AIRE,STATO CIVILE,7,13,20
3,2022,AIRE,STATO FAMIGLIA,185,205,390
3,2022,AIRE,STATO FAMIGLIA CON RAPPORTI PARENTELA,5,0,5
3,2022,AIRE,STATO FAMIGLIA E STATO CIVILE,5,4,9
3,2022,AIRE,STATO LIBERO,4,4,8
3,2022,AIRE,UNIONE CIVILE ,7,1,8
3,2022,Residenti,CITTADINANZA,2087,1405,3492
3,2022,Residenti,CONTESTUALE,46111,42842,88953
3,2022,Residenti,CONTRATTO CONVIVENZA,7,9,16
3,2022,Residenti,ESISTENZA IN VITA,1397,1508,2905
3,2022,Residenti,MATRIMONIO,9399,12218,21617
3,2022,Residenti,NASCITA,11122,12275,23397
3,2022,Residenti,RESIDENZA,37376,46418,83794
3,2022,Residenti,RESIDENZA IN CONVIVENZA,57,44,101
3,2022,Residenti,STATO CIVILE,9845,10096,19941
3,2022,Residenti,STATO FAMIGLIA,36211,46040,82251
3,2022,Residenti,STATO FAMIGLIA CON RAPPORTI PARENTELA,6491,8215,14706
3,2022,Residenti,STATO FAMIGLIA E STATO CIVILE,6727,7661,14388
3,2022,Residenti,STATO LIBERO,6607,5062,11669
3,2022,Residenti,UNIONE CIVILE ,40,48,88
4,2022,AIRE,CITTADINANZA,96,87,183
4,2022,AIRE,CONTESTUALE,346,283,629
4,2022,AIRE,ESISTENZA IN VITA,1,1,2
4,2022,AIRE,MATRIMONIO,71,120,191
4,2022,AIRE,NASCITA,273,228,501
4,2022,AIRE,RESIDENZA,341,448,789
4,2022,AIRE,STATO CIVILE,4,4,8
4,2022,AIRE,STATO FAMIGLIA,160,204,364
4,2022,AIRE,STATO FAMIGLIA CON RAPPORTI PARENTELA,0,6,6
4,2022,AIRE,STATO FAMIGLIA E STATO CIVILE,3,2,5
4,2022,AIRE,STATO LIBERO,1,4,5
4,2022,AIRE,UNIONE CIVILE ,0,2,2
4,2022,Residenti,CITTADINANZA,1640,1203,2843
4,2022,Residenti,CONTESTUALE,36740,34715,71455
4,2022,Residenti,CONTRATTO CONVIVENZA,9,4,13
4,2022,Residenti,ESISTENZA IN VITA,1050,1285,2335
4,2022,Residenti,MATRIMONIO,7535,9512,17047
4,2022,Residenti,NASCITA,9156,9970,19126
4,2022,Residenti,RESIDENZA,32041,39889,71930
4,2022,Residenti,RESIDENZA IN CONVIVENZA,47,45,92
4,2022,Residenti,STATO CIVILE,7781,8347,16128
4,2022,Residenti,STATO FAMIGLIA,27775,34670,62445
4,2022,Residenti,STATO FAMIGLIA CON RAPPORTI PARENTELA,5302,6368,11670
4,2022,Residenti,STATO FAMIGLIA E STATO CIVILE,5328,5971,11299
4,2022,Residenti,STATO LIBERO,5488,4268,9756
4,2022,Residenti,UNIONE CIVILE ,51,36,87
5,2022,AIRE,CITTADINANZA,112,86,198
5,2022,AIRE,CONTESTUALE,394,321,715
5,2022,AIRE,MATRIMONIO,116,138,254
5,2022,AIRE,NASCITA,329,244,573
5,2022,AIRE,RESIDENZA,358,416,774
5,2022,AIRE,STATO CIVILE,8,10,18
5,2022,AIRE,STATO FAMIGLIA,188,189,377
5,2022,AIRE,STATO FAMIGLIA CON RAPPORTI PARENTELA,1,5,6
5,2022,AIRE,STATO FAMIGLIA E STATO CIVILE,3,2,5
5,2022,AIRE,STATO LIBERO,4,3,7
5,2022,AIRE,UNIONE CIVILE ,0,1,1
5,2022,Residenti,CITTADINANZA,1764,1366,3130
5,2022,Residenti,CONTESTUALE,40274,38762,79036
5,2022,Residenti,CONTRATTO CONVIVENZA,19,7,26
5,2022,Residenti,ESISTENZA IN VITA,1171,1377,2548
5,2022,Residenti,MATRIMONIO,8364,11035,19399
5,2022,Residenti,NASCITA,9861,11376,21237
5,2022,Residenti,RESIDENZA,38592,46659,85251
5,2022,Residenti,RESIDENZA IN CONVIVENZA,43,51,94
5,2022,Residenti,STATO CIVILE,9319,9929,19248
5,2022,Residenti,STATO FAMIGLIA,33248,41438,74686
5,2022,Residenti,STATO FAMIGLIA CON RAPPORTI PARENTELA,5995,7389,13384
5,2022,Residenti,STATO FAMIGLIA E STATO CIVILE,6023,6935,12958
5,2022,Residenti,STATO LIBERO,6297,4989,11286
5,2022,Residenti,UNIONE CIVILE ,38,33,71
6,2022,AIRE,CITTADINANZA,123,82,205
6,2022,AIRE,CONTESTUALE,320,257,577
6,2022,AIRE,MATRIMONIO,85,101,186
6,2022,AIRE,NASCITA,284,226,510
6,2022,AIRE,RESIDENZA,291,380,671
6,2022,AIRE,STATO CIVILE,6,6,12
6,2022,AIRE,STATO FAMIGLIA,175,209,384
6,2022,AIRE,STATO FAMIGLIA CON RAPPORTI PARENTELA,2,5,7
6,2022,AIRE,STATO FAMIGLIA E STATO CIVILE,2,1,3
6,2022,AIRE,STATO LIBERO,4,2,6
6,2022,AIRE,UNIONE CIVILE ,1,0,1
6,2022,Residenti,CITTADINANZA,1799,1390,3189
6,2022,Residenti,CONTESTUALE,36966,37010,73976
6,2022,Residenti,CONTRATTO CONVIVENZA,17,6,23
6,2022,Residenti,ESISTENZA IN VITA,1081,1377,2458
6,2022,Residenti,MATRIMONIO,8431,10562,18993
6,2022,Residenti,NASCITA,9161,10056,19217
6,2022,Residenti,RESIDENZA,35242,43615,78857
6,2022,Residenti,RESIDENZA IN CONVIVENZA,39,44,83
6,2022,Residenti,STATO CIVILE,8924,9557,18481
6,2022,Residenti,STATO FAMIGLIA,30445,38068,68513
6,2022,Residenti,STATO FAMIGLIA CON RAPPORTI PARENTELA,5606,6724,12330
6,2022,Residenti,STATO FAMIGLIA E STATO CIVILE,5333,6399,11732
6,2022,Residenti,STATO LIBERO,5698,4747,10445
6,2022,Residenti,UNIONE CIVILE ,41,40,81
7,2022,AIRE,CITTADINANZA,94,76,170
7,2022,AIRE,CONTESTUALE,300,260,560
7,2022,AIRE,ESISTENZA IN VITA,2,0,2
7,2022,AIRE,MATRIMONIO,109,121,230
7,2022,AIRE,NASCITA,264,223,487
7,2022,AIRE,RESIDENZA,320,366,686
7,2022,AIRE,STATO CIVILE,6,6,12
7,2022,AIRE,STATO FAMIGLIA,182,188,370
7,2022,AIRE,STATO FAMIGLIA CON RAPPORTI PARENTELA,1,1,2
7,2022,AIRE,STATO FAMIGLIA E STATO CIVILE,1,2,3
7,2022,AIRE,STATO LIBERO,1,0,1
7,2022,AIRE,UNIONE CIVILE ,2,0,2
7,2022,Residenti,CITTADINANZA,1550,1187,2737
7,2022,Residenti,CONTESTUALE,31993,44433,76426
7,2022,Residenti,CONTRATTO CONVIVENZA,15,16,31
7,2022,Residenti,ESISTENZA IN VITA,1043,1299,2342
7,2022,Residenti,MATRIMONIO,8067,9855,17922
7,2022,Residenti,NASCITA,8592,9659,18251
7,2022,Residenti,RESIDENZA,32552,40575,73127
7,2022,Residenti,RESIDENZA IN CONVIVENZA,40,29,69
7,2022,Residenti,STATO CIVILE,7905,8464,16369
7,2022,Residenti,STATO FAMIGLIA,27218,36968,64186
7,2022,Residenti,STATO FAMIGLIA CON RAPPORTI PARENTELA,5205,6556,11761
7,2022,Residenti,STATO FAMIGLIA E STATO CIVILE,4966,5553,10519
7,2022,Residenti,STATO LIBERO,4874,4116,8990
7,2022,Residenti,UNIONE CIVILE ,52,50,102
8,2022,AIRE,CITTADINANZA,104,69,173
8,2022,AIRE,CONTESTUALE,331,271,602
8,2022,AIRE,ESISTENZA IN VITA,2,0,2
8,2022,AIRE,MATRIMONIO,87,87,174
8,2022,AIRE,NASCITA,338,271,609
8,2022,AIRE,RESIDENZA,315,364,679
8,2022,AIRE,STATO CIVILE,5,1,6
8,2022,AIRE,STATO FAMIGLIA,175,179,354
8,2022,AIRE,STATO FAMIGLIA CON RAPPORTI PARENTELA,7,4,11
8,2022,AIRE,STATO FAMIGLIA E STATO CIVILE,1,1,2
8,2022,AIRE,STATO LIBERO,2,0,2
8,2022,AIRE,UNIONE CIVILE ,0,3,3
8,2022,Residenti,CITTADINANZA,1381,1022,2403
8,2022,Residenti,CONTESTUALE,24090,35079,59169
8,2022,Residenti,CONTRATTO CONVIVENZA,13,11,24
8,2022,Residenti,ESISTENZA IN VITA,799,962,1761
8,2022,Residenti,ISCRIZIONE NELLE LISTE ELETTORALI,0,1,1
8,2022,Residenti,MATRIMONIO,5387,5995,11382
8,2022,Residenti,NASCITA,7908,8471,16379
8,2022,Residenti,RESIDENZA,27584,33879,61463
8,2022,Residenti,RESIDENZA IN CONVIVENZA,25,40,65
8,2022,Residenti,STATO CIVILE,4634,5117,9751
8,2022,Residenti,STATO FAMIGLIA,21734,29612,51346
8,2022,Residenti,STATO FAMIGLIA CON RAPPORTI PARENTELA,4241,5402,9643
8,2022,Residenti,STATO FAMIGLIA E STATO CIVILE,3426,4095,7521
8,2022,Residenti,STATO LIBERO,2327,1883,4210
8,2022,Residenti,UNIONE CIVILE ,32,35,67
9,2022,AIRE,CITTADINANZA,127,62,189
9,2022,AIRE,CONTESTUALE,330,289,619
9,2022,AIRE,ESISTENZA IN VITA,3,4,7
9,2022,AIRE,MATRIMONIO,118,123,241
9,2022,AIRE,NASCITA,301,276,577
9,2022,AIRE,RESIDENZA,297,403,700
9,2022,AIRE,STATO CIVILE,10,5,15
9,2022,AIRE,STATO FAMIGLIA,187,196,383
9,2022,AIRE,STATO FAMIGLIA CON RAPPORTI PARENTELA,7,3,10
9,2022,AIRE,STATO FAMIGLIA E STATO CIVILE,3,0,3
9,2022,AIRE,STATO LIBERO,3,4,7
9,2022,Residenti,CITTADINANZA,2250,1875,4125
9,2022,Residenti,CONTESTUALE,42830,85841,128671
9,2022,Residenti,CONTRATTO CONVIVENZA,11,21,32
9,2022,Residenti,ESISTENZA IN VITA,1358,1396,2754
9,2022,Residenti,MATRIMONIO,9560,12016,21576
9,2022,Residenti,NASCITA,10996,14302,25298
9,2022,Residenti,RESIDENZA,40614,53432,94046
9,2022,Residenti,RESIDENZA IN CONVIVENZA,53,59,112
9,2022,Residenti,STATO CIVILE,9353,10141,19494
9,2022,Residenti,STATO FAMIGLIA,35163,55497,90660
9,2022,Residenti,STATO FAMIGLIA CON RAPPORTI PARENTELA,6477,8541,15018
9,2022,Residenti,STATO FAMIGLIA E STATO CIVILE,5687,6983,12670
9,2022,Residenti,STATO LIBERO,5631,4877,10508
9,2022,Residenti,UNIONE CIVILE ,46,62,108
10,2022,AIRE,CITTADINANZA,121,73,194
10,2022,AIRE,CONTESTUALE,344,317,661
10,2022,AIRE,ESISTENZA IN VITA,1,0,1
10,2022,AIRE,MATRIMONIO,111,114,225
10,2022,AIRE,NASCITA,336,269,605
10,2022,AIRE,RESIDENZA,353,387,740
10,2022,AIRE,STATO CIVILE,13,6,19
10,2022,AIRE,STATO FAMIGLIA,197,208,405
10,2022,AIRE,STATO FAMIGLIA CON RAPPORTI PARENTELA,7,5,12
10,2022,AIRE,STATO FAMIGLIA E STATO CIVILE,5,3,8
10,2022,AIRE,STATO LIBERO,6,5,11
10,2022,Residenti,CITTADINANZA,2086,1746,3832
10,2022,Residenti,CONTESTUALE,42101,68103,110204
10,2022,Residenti,CONTRATTO CONVIVENZA,14,17,31
10,2022,Residenti,ESISTENZA IN VITA,1289,1428,2717
10,2022,Residenti,GODIMENTO DEI DIRITTI POLITICI,0,1,1
10,2022,Residenti,ISCRIZIONE NELLE LISTE ELETTORALI,0,1,1
10,2022,Residenti,MATRIMONIO,9494,11652,21146
10,2022,Residenti,NASCITA,10288,12904,23192
10,2022,Residenti,RESIDENZA,40349,52442,92791
10,2022,Residenti,RESIDENZA IN CONVIVENZA,50,50,100
10,2022,Residenti,STATO CIVILE,9048,9899,18947
10,2022,Residenti,STATO FAMIGLIA,35779,50429,86208
10,2022,Residenti,STATO FAMIGLIA CON RAPPORTI PARENTELA,6606,8440,15046
10,2022,Residenti,STATO FAMIGLIA E STATO CIVILE,6136,7372,13508
10,2022,Residenti,STATO LIBERO,5075,4548,9623
10,2022,Residenti,UNIONE CIVILE ,54,48,102
11,2022,AIRE,CITTADINANZA,145,66,211
11,2022,AIRE,CONTESTUALE,381,335,716
11,2022,AIRE,ESISTENZA IN VITA,2,1,3
11,2022,AIRE,MATRIMONIO,118,123,241
11,2022,AIRE,NASCITA,353,270,623
11,2022,AIRE,RESIDENZA,349,344,693
11,2022,AIRE,STATO CIVILE,9,3,12
11,2022,AIRE,STATO FAMIGLIA,204,197,401
11,2022,AIRE,STATO FAMIGLIA CON RAPPORTI PARENTELA,3,2,5
11,2022,AIRE,STATO FAMIGLIA E STATO CIVILE,4,6,10
11,2022,AIRE,STATO LIBERO,1,2,3
11,2022,AIRE,UNIONE CIVILE ,0,1,1
11,2022,Residenti,CITTADINANZA,2259,1693,3952
11,2022,Residenti,CONTESTUALE,40156,50169,90325
11,2022,Residenti,CONTRATTO CONVIVENZA,17,8,25
11,2022,Residenti,ESISTENZA IN VITA,1410,1599,3009
11,2022,Residenti,GODIMENTO DEI DIRITTI POLITICI,0,3,3
11,2022,Residenti,ISCRIZIONE NELLE LISTE ELETTORALI,0,1,1
11,2022,Residenti,MATRIMONIO,8825,11591,20416
11,2022,Residenti,NASCITA,10369,11897,22266
11,2022,Residenti,RESIDENZA,39652,48729,88381
11,2022,Residenti,RESIDENZA IN CONVIVENZA,50,48,98
11,2022,Residenti,STATO CIVILE,9668,10225,19893
11,2022,Residenti,STATO FAMIGLIA,33615,45353,78968
11,2022,Residenti,STATO FAMIGLIA CON RAPPORTI PARENTELA,6875,8578,15453
11,2022,Residenti,STATO FAMIGLIA E STATO CIVILE,5979,6981,12960
11,2022,Residenti,STATO LIBERO,5499,4986,10485
11,2022,Residenti,UNIONE CIVILE ,62,37,99
12,2022,AIRE,CITTADINANZA,168,59,227
12,2022,AIRE,CONTESTUALE,432,310,742
12,2022,AIRE,ESISTENZA IN VITA,1,1,2
12,2022,AIRE,MATRIMONIO,110,113,223
12,2022,AIRE,NASCITA,324,244,568
12,2022,AIRE,RESIDENZA,441,368,809
12,2022,AIRE,STATO CIVILE,8,5,13
12,2022,AIRE,STATO FAMIGLIA,241,187,428
12,2022,AIRE,STATO FAMIGLIA CON RAPPORTI PARENTELA,4,3,7
12,2022,AIRE,STATO FAMIGLIA E STATO CIVILE,2,2,4
12,2022,AIRE,STATO LIBERO,2,1,3
12,2022,AIRE,UNIONE CIVILE ,1,0,1
12,2022,Residenti,CITTADINANZA,2678,1381,4059
12,2022,Residenti,CONTESTUALE,34643,34589,69232
12,2022,Residenti,CONTRATTO CONVIVENZA,18,9,27
12,2022,Residenti,ESISTENZA IN VITA,1954,1536,3490
12,2022,Residenti,MATRIMONIO,7292,8388,15680
12,2022,Residenti,NASCITA,9745,9085,18830
12,2022,Residenti,RESIDENZA,35122,40044,75166
12,2022,Residenti,RESIDENZA IN CONVIVENZA,44,52,96
12,2022,Residenti,STATO CIVILE,8353,7920,16273
12,2022,Residenti,STATO FAMIGLIA,29661,35101,64762
12,2022,Residenti,STATO FAMIGLIA CON RAPPORTI PARENTELA,6626,6767,13393
12,2022,Residenti,STATO FAMIGLIA E STATO CIVILE,5832,5354,11186
12,2022,Residenti,STATO LIBERO,4851,3378,8229
12,2022,Residenti,UNIONE CIVILE ,42,35,77
1,2023,AIRE,CITTADINANZA,13,187,200
1,2023,AIRE,CONTESTUALE,38,823,861
1,2023,AIRE,ESISTENZA IN VITA,0,4,4
1,2023,AIRE,MATRIMONIO,14,221,235
1,2023,AIRE,NASCITA,29,572,601
1,2023,AIRE,RESIDENZA,35,896,931
1,2023,AIRE,STATO CIVILE,2,21,23
1,2023,AIRE,STATO FAMIGLIA,23,415,438
1,2023,AIRE,STATO FAMIGLIA CON RAPPORTI PARENTELA,0,11,11
1,2023,AIRE,STATO FAMIGLIA E STATO CIVILE,0,6,6
1,2023,AIRE,STATO LIBERO,1,10,11
1,2023,AIRE,UNIONE CIVILE ,0,2,2
1,2023,Residenti,CITTADINANZA,136,3170,3306
1,2023,Residenti,CONTESTUALE,2289,90070,92359
1,2023,Residenti,CONTRATTO CONVIVENZA,0,26,26
1,2023,Residenti,ESISTENZA IN VITA,104,2996,3100
1,2023,Residenti,MATRIMONIO,408,17709,18117
1,2023,Residenti,NASCITA,711,22000,22711
1,2023,Residenti,RESIDENZA,2468,93793,96261
1,2023,Residenti,RESIDENZA IN CONVIVENZA,4,116,120
1,2023,Residenti,STATO CIVILE,439,17617,18056
1,2023,Residenti,STATO FAMIGLIA,3223,117393,120616
1,2023,Residenti,STATO FAMIGLIA CON RAPPORTI PARENTELA,463,18712,19175
1,2023,Residenti,STATO FAMIGLIA E STATO CIVILE,454,15315,15769
1,2023,Residenti,STATO LIBERO,212,7721,7933
1,2023,Residenti,UNIONE CIVILE ,2,76,78
2,2023,AIRE,CITTADINANZA,0,183,183
2,2023,AIRE,CONTESTUALE,0,735,735
2,2023,AIRE,ESISTENZA IN VITA,0,2,2
2,2023,AIRE,MATRIMONIO,0,232,232
2,2023,AIRE,NASCITA,0,597,597
2,2023,AIRE,RESIDENZA,0,753,753
2,2023,AIRE,STATO CIVILE,0,20,20
2,2023,AIRE,STATO FAMIGLIA,0,410,410
2,2023,AIRE,STATO FAMIGLIA CON RAPPORTI PARENTELA,0,11,11
2,2023,AIRE,STATO FAMIGLIA E STATO CIVILE,0,11,11
2,2023,AIRE,STATO LIBERO,0,11,11
2,2023,AIRE,UNIONE CIVILE ,0,6,6
2,2023,Residenti,CITTADINANZA,0,2962,2962
2,2023,Residenti,CONTESTUALE,0,86200,86200
2,2023,Residenti,CONTRATTO CONVIVENZA,0,18,18
2,2023,Residenti,ESISTENZA IN VITA,0,2287,2287
2,2023,Residenti,MATRIMONIO,0,18135,18135
2,2023,Residenti,NASCITA,0,19854,19854
2,2023,Residenti,RESIDENZA,0,87879,87879
2,2023,Residenti,RESIDENZA IN CONVIVENZA,0,106,106
2,2023,Residenti,STATO CIVILE,0,17801,17801
2,2023,Residenti,STATO FAMIGLIA,0,88366,88366
2,2023,Residenti,STATO FAMIGLIA CON RAPPORTI PARENTELA,0,14597,14597
2,2023,Residenti,STATO FAMIGLIA E STATO CIVILE,0,12994,12994
2,2023,Residenti,STATO LIBERO,0,8331,8331
2,2023,Residenti,UNIONE CIVILE ,0,79,79
3,2023,AIRE,CITTADINANZA,0,185,185
3,2023,AIRE,CONTESTUALE,0,763,763
3,2023,AIRE,ESISTENZA IN VITA,0,6,6
3,2023,AIRE,MATRIMONIO,0,284,284
3,2023,AIRE,NASCITA,0,561,561
3,2023,AIRE,RESIDENZA,0,895,895
3,2023,AIRE,STATO CIVILE,0,20,20
3,2023,AIRE,STATO FAMIGLIA,0,391,391
3,2023,AIRE,STATO FAMIGLIA CON RAPPORTI PARENTELA,0,14,14
3,2023,AIRE,STATO FAMIGLIA E STATO CIVILE,0,8,8
3,2023,AIRE,STATO LIBERO,0,8,8
3,2023,AIRE,UNIONE CIVILE ,0,2,2
3,2023,Residenti,CITTADINANZA,0,2957,2957
3,2023,Residenti,CONTESTUALE,0,85705,85705
3,2023,Residenti,CONTRATTO CONVIVENZA,0,23,23
3,2023,Residenti,ESISTENZA IN VITA,0,2344,2344
3,2023,Residenti,MATRIMONIO,0,17003,17003
3,2023,Residenti,NASCITA,0,19896,19896
3,2023,Residenti,RESIDENZA,0,88534,88534
3,2023,Residenti,RESIDENZA IN CONVIVENZA,0,101,101
3,2023,Residenti,STATO CIVILE,0,17275,17275
3,2023,Residenti,STATO FAMIGLIA,0,77946,77946
3,2023,Residenti,STATO FAMIGLIA CON RAPPORTI PARENTELA,0,13166,13166
3,2023,Residenti,STATO FAMIGLIA E STATO CIVILE,0,11759,11759
3,2023,Residenti,STATO LIBERO,0,7660,7660
3,2023,Residenti,UNIONE CIVILE ,0,81,81
4,2023,AIRE,CITTADINANZA,0,155,155
4,2023,AIRE,CONTESTUALE,0,621,621
4,2023,AIRE,ESISTENZA IN VITA,0,4,4
4,2023,AIRE,MATRIMONIO,0,189,189
4,2023,AIRE,NASCITA,0,441,441
4,2023,AIRE,RESIDENZA,0,698,698
4,2023,AIRE,STATO CIVILE,0,15,15
4,2023,AIRE,STATO FAMIGLIA,0,326,326
4,2023,AIRE,STATO FAMIGLIA CON RAPPORTI PARENTELA,0,4,4
4,2023,AIRE,STATO FAMIGLIA E STATO CIVILE,0,4,4
4,2023,AIRE,STATO LIBERO,0,6,6
4,2023,AIRE,UNIONE CIVILE ,0,3,3
4,2023,Residenti,CITTADINANZA,0,2346,2346
4,2023,Residenti,CONTESTUALE,0,63585,63585
4,2023,Residenti,CONTRATTO CONVIVENZA,0,13,13
4,2023,Residenti,ESISTENZA IN VITA,0,1627,1627
4,2023,Residenti,MATRIMONIO,0,11893,11893
4,2023,Residenti,NASCITA,0,14550,14550
4,2023,Residenti,RESIDENZA,0,69037,69037
4,2023,Residenti,RESIDENZA IN CONVIVENZA,0,88,88
4,2023,Residenti,STATO CIVILE,0,12478,12478
4,2023,Residenti,STATO FAMIGLIA,0,54492,54492
4,2023,Residenti,STATO FAMIGLIA CON RAPPORTI PARENTELA,0,9422,9422
4,2023,Residenti,STATO FAMIGLIA E STATO CIVILE,0,8586,8586
4,2023,Residenti,STATO LIBERO,0,5507,5507
4,2023,Residenti,UNIONE CIVILE ,0,63,63
5,2023,AIRE,CITTADINANZA,0,139,139
5,2023,AIRE,CONTESTUALE,0,617,617
5,2023,AIRE,ESISTENZA IN VITA,0,4,4
5,2023,AIRE,MATRIMONIO,0,238,238
5,2023,AIRE,NASCITA,0,446,446
5,2023,AIRE,RESIDENZA,0,789,789
5,2023,AIRE,STATO CIVILE,0,16,16
5,2023,AIRE,STATO FAMIGLIA,0,380,380
5,2023,AIRE,STATO FAMIGLIA CON RAPPORTI PARENTELA,0,8,8
5,2023,AIRE,STATO FAMIGLIA E STATO CIVILE,0,11,11
5,2023,AIRE,STATO LIBERO,0,8,8
5,2023,AIRE,UNIONE CIVILE ,0,4,4
5,2023,Residenti,CITTADINANZA,0,2759,2759
5,2023,Residenti,CONTESTUALE,0,78275,78275
5,2023,Residenti,CONTRATTO CONVIVENZA,0,14,14
5,2023,Residenti,ESISTENZA IN VITA,0,1959,1959
5,2023,Residenti,MATRIMONIO,0,16011,16011
5,2023,Residenti,NASCITA,0,17403,17403
5,2023,Residenti,RESIDENZA,0,84702,84702
5,2023,Residenti,RESIDENZA IN CONVIVENZA,0,118,118
5,2023,Residenti,STATO CIVILE,0,15938,15938
5,2023,Residenti,STATO FAMIGLIA,0,65953,65953
5,2023,Residenti,STATO FAMIGLIA CON RAPPORTI PARENTELA,0,11085,11085
5,2023,Residenti,STATO FAMIGLIA E STATO CIVILE,0,10373,10373
5,2023,Residenti,STATO LIBERO,0,6470,6470
5,2023,Residenti,UNIONE CIVILE ,0,95,95
6,2023,AIRE,CITTADINANZA,0,121,121
6,2023,AIRE,CONTESTUALE,0,582,582
6,2023,AIRE,ESISTENZA IN VITA,0,3,3
6,2023,AIRE,MATRIMONIO,0,181,181
6,2023,AIRE,NASCITA,0,461,461
6,2023,AIRE,RESIDENZA,0,755,755
6,2023,AIRE,STATO CIVILE,0,12,12
6,2023,AIRE,STATO FAMIGLIA,0,312,312
6,2023,AIRE,STATO FAMIGLIA CON RAPPORTI PARENTELA,0,4,4
6,2023,AIRE,STATO FAMIGLIA E STATO CIVILE,0,3,3
6,2023,AIRE,STATO LIBERO,0,6,6
6,2023,Residenti,CITTADINANZA,0,2485,2485
6,2023,Residenti,CONTESTUALE,0,67641,67641
6,2023,Residenti,CONTRATTO CONVIVENZA,0,11,11
6,2023,Residenti,ESISTENZA IN VITA,0,2082,2082
6,2023,Residenti,MATRIMONIO,0,14680,14680
6,2023,Residenti,NASCITA,0,15886,15886
6,2023,Residenti,RESIDENZA,0,75549,75549
6,2023,Residenti,RESIDENZA IN CONVIVENZA,0,85,85
6,2023,Residenti,STATO CIVILE,0,13706,13706
6,2023,Residenti,STATO FAMIGLIA,0,59953,59953
6,2023,Residenti,STATO FAMIGLIA CON RAPPORTI PARENTELA,0,10307,10307
6,2023,Residenti,STATO FAMIGLIA E STATO CIVILE,0,9033,9033
6,2023,Residenti,STATO LIBERO,0,5752,5752
6,2023,Residenti,UNIONE CIVILE ,0,70,70
7,2023,AIRE,CITTADINANZA,0,149,149
7,2023,AIRE,CONTESTUALE,0,600,600
7,2023,AIRE,ESISTENZA IN VITA,0,3,3
7,2023,AIRE,MATRIMONIO,0,195,195
7,2023,AIRE,NASCITA,0,477,477
7,2023,AIRE,RESIDENZA,0,648,648
7,2023,AIRE,STATO CIVILE,0,14,14
7,2023,AIRE,STATO FAMIGLIA,0,304,304
7,2023,AIRE,STATO FAMIGLIA CON RAPPORTI PARENTELA,0,5,5
7,2023,AIRE,STATO FAMIGLIA E STATO CIVILE,0,3,3
7,2023,AIRE,STATO LIBERO,0,7,7
7,2023,AIRE,UNIONE CIVILE ,0,6,6
7,2023,Residenti,CITTADINANZA,0,2203,2203
7,2023,Residenti,CONTESTUALE,0,83791,83791
7,2023,Residenti,CONTRATTO CONVIVENZA,0,16,16
7,2023,Residenti,ESISTENZA IN VITA,0,1835,1835
7,2023,Residenti,MATRIMONIO,0,14337,14337
7,2023,Residenti,NASCITA,0,16022,16022
7,2023,Residenti,RESIDENZA,0,73439,73439
7,2023,Residenti,RESIDENZA IN CONVIVENZA,0,90,90
7,2023,Residenti,STATO CIVILE,0,12768,12768
7,2023,Residenti,STATO FAMIGLIA,0,64306,64306
7,2023,Residenti,STATO FAMIGLIA CON RAPPORTI PARENTELA,0,10550,10550
7,2023,Residenti,STATO FAMIGLIA E STATO CIVILE,0,8314,8314
7,2023,Residenti,STATO LIBERO,0,5150,5150
7,2023,Residenti,UNIONE CIVILE ,0,97,97
8,2023,AIRE,CITTADINANZA,9,86,95
8,2023,AIRE,CONTESTUALE,61,373,434
8,2023,AIRE,MATRIMONIO,23,139,162
8,2023,AIRE,NASCITA,96,325,421
8,2023,AIRE,RESIDENZA,100,469,569
8,2023,AIRE,STATO CIVILE,2,8,10
8,2023,AIRE,STATO FAMIGLIA,22,203,225
8,2023,AIRE,STATO FAMIGLIA CON RAPPORTI PARENTELA,1,2,3
8,2023,AIRE,STATO FAMIGLIA E STATO CIVILE,0,1,1
8,2023,AIRE,STATO LIBERO,2,1,3
8,2023,AIRE,UNIONE CIVILE ,1,1,2
8,2023,Residenti,CITTADINANZA,69,1771,1840
8,2023,Residenti,CONTESTUALE,5209,61019,66228
8,2023,Residenti,CONTRATTO CONVIVENZA,3,13,16
8,2023,Residenti,ESISTENZA IN VITA,90,1037,1127
8,2023,Residenti,MATRIMONIO,744,7646,8390
8,2023,Residenti,NASCITA,1164,11390,12554
8,2023,Residenti,RESIDENZA,3280,52705,55985
8,2023,Residenti,RESIDENZA IN CONVIVENZA,1,57,58
8,2023,Residenti,STATO CIVILE,692,6591,7283
8,2023,Residenti,STATO FAMIGLIA,3372,43442,46814
8,2023,Residenti,STATO FAMIGLIA CON RAPPORTI PARENTELA,502,7209,7711
8,2023,Residenti,STATO FAMIGLIA E STATO CIVILE,417,5582,5999
8,2023,Residenti,STATO LIBERO,768,2108,2876
8,2023,Residenti,UNIONE CIVILE ,10,49,59
9,2023,AIRE,CITTADINANZA,11,104,115
9,2023,AIRE,CONTESTUALE,89,427,516
9,2023,AIRE,ESISTENZA IN VITA,0,1,1
9,2023,AIRE,MATRIMONIO,30,180,210
9,2023,AIRE,NASCITA,133,279,412
9,2023,AIRE,RESIDENZA,122,511,633
9,2023,AIRE,STATO CIVILE,1,8,9
9,2023,AIRE,STATO FAMIGLIA,38,239,277
9,2023,AIRE,STATO FAMIGLIA CON RAPPORTI PARENTELA,0,7,7
9,2023,AIRE,STATO FAMIGLIA E STATO CIVILE,0,8,8
9,2023,AIRE,STATO LIBERO,4,7,11
9,2023,AIRE,UNIONE CIVILE ,1,0,1
9,2023,Residenti,CITTADINANZA,104,2183,2287
9,2023,Residenti,CONTESTUALE,9129,133571,142700
9,2023,Residenti,CONTRATTO CONVIVENZA,1,9,10
9,2023,Residenti,ESISTENZA IN VITA,148,1533,1681
9,2023,Residenti,MATRIMONIO,1601,13138,14739
9,2023,Residenti,NASCITA,1649,17413,19062
9,2023,Residenti,RESIDENZA,5167,73776,78943
9,2023,Residenti,RESIDENZA IN CONVIVENZA,2,76,78
9,2023,Residenti,STATO CIVILE,2008,12158,14166
9,2023,Residenti,STATO FAMIGLIA,5681,73223,78904
9,2023,Residenti,STATO FAMIGLIA CON RAPPORTI PARENTELA,721,10995,11716
9,2023,Residenti,STATO FAMIGLIA E STATO CIVILE,789,9020,9809
9,2023,Residenti,STATO LIBERO,1924,4384,6308
9,2023,Residenti,UNIONE CIVILE ,13,76,89
10,2023,AIRE,CITTADINANZA,6,99,105
10,2023,AIRE,CONTESTUALE,108,467,575
10,2023,AIRE,ESISTENZA IN VITA,0,2,2
10,2023,AIRE,MATRIMONIO,24,181,205
10,2023,AIRE,NASCITA,96,354,450
10,2023,AIRE,RESIDENZA,124,665,789
10,2023,AIRE,STATO CIVILE,2,10,12
10,2023,AIRE,STATO FAMIGLIA,36,257,293
10,2023,AIRE,STATO FAMIGLIA CON RAPPORTI PARENTELA,0,6,6
10,2023,AIRE,STATO FAMIGLIA E STATO CIVILE,0,4,4
10,2023,AIRE,STATO LIBERO,3,1,4
10,2023,AIRE,UNIONE CIVILE ,0,1,1
10,2023,Residenti,CITTADINANZA,127,2357,2484
10,2023,Residenti,CONTESTUALE,10173,103167,113340
10,2023,Residenti,CONTRATTO CONVIVENZA,3,16,19
10,2023,Residenti,ESISTENZA IN VITA,181,1815,1996
10,2023,Residenti,MATRIMONIO,1658,14721,16379
10,2023,Residenti,NASCITA,1524,16878,18402
10,2023,Residenti,RESIDENZA,5587,76157,81744
10,2023,Residenti,RESIDENZA IN CONVIVENZA,5,95,100
10,2023,Residenti,STATO CIVILE,2150,12685,14835
10,2023,Residenti,STATO FAMIGLIA,5659,68668,74327
10,2023,Residenti,STATO FAMIGLIA CON RAPPORTI PARENTELA,774,10947,11721
10,2023,Residenti,STATO FAMIGLIA E STATO CIVILE,905,9513,10418
10,2023,Residenti,STATO LIBERO,2132,4548,6680
10,2023,Residenti,UNIONE CIVILE ,9,73,82
11,2023,AIRE,CITTADINANZA,7,109,116
11,2023,AIRE,CONTESTUALE,99,442,541
11,2023,AIRE,MATRIMONIO,21,172,193
11,2023,AIRE,NASCITA,135,310,445
11,2023,AIRE,RESIDENZA,124,603,727
11,2023,AIRE,STATO CIVILE,3,5,8
11,2023,AIRE,STATO FAMIGLIA,28,244,272
11,2023,AIRE,STATO FAMIGLIA CON RAPPORTI PARENTELA,0,5,5
11,2023,AIRE,STATO FAMIGLIA E STATO CIVILE,1,0,1
11,2023,AIRE,STATO LIBERO,1,3,4
11,2023,Residenti,CITTADINANZA,92,1964,2056
11,2023,Residenti,CONTESTUALE,9613,69624,79237
11,2023,Residenti,CONTRATTO CONVIVENZA,1,10,11
11,2023,Residenti,ESISTENZA IN VITA,177,1817,1994
11,2023,Residenti,MATRIMONIO,1389,13313,14702
11,2023,Residenti,NASCITA,1437,14156,15593
11,2023,Residenti,RESIDENZA,4963,70181,75144
11,2023,Residenti,RESIDENZA IN CONVIVENZA,1,66,67
11,2023,Residenti,STATO CIVILE,2107,11989,14096
11,2023,Residenti,STATO FAMIGLIA,5475,60592,66067
11,2023,Residenti,STATO FAMIGLIA CON RAPPORTI PARENTELA,771,10645,11416
11,2023,Residenti,STATO FAMIGLIA E STATO CIVILE,817,8706,9523
11,2023,Residenti,STATO LIBERO,2405,4895,7300
11,2023,Residenti,UNIONE CIVILE ,21,69,90
12,2023,AIRE,CITTADINANZA,16,88,104
12,2023,AIRE,CONTESTUALE,110,426,536
12,2023,AIRE,ESISTENZA IN VITA,0,2,2
12,2023,AIRE,MATRIMONIO,24,147,171
12,2023,AIRE,NASCITA,102,278,380
12,2023,AIRE,RESIDENZA,86,610,696
12,2023,AIRE,STATO CIVILE,2,8,10
12,2023,AIRE,STATO FAMIGLIA,25,220,245
12,2023,AIRE,STATO FAMIGLIA CON RAPPORTI PARENTELA,0,7,7
12,2023,AIRE,STATO FAMIGLIA E STATO CIVILE,0,2,2
12,2023,AIRE,STATO LIBERO,2,2,4
12,2023,AIRE,UNIONE CIVILE ,1,0,1
12,2023,Residenti,CITTADINANZA,95,1832,1927
12,2023,Residenti,CONTESTUALE,7665,60097,67762
12,2023,Residenti,CONTRATTO CONVIVENZA,2,10,12
12,2023,Residenti,ESISTENZA IN VITA,166,2268,2434
12,2023,Residenti,MATRIMONIO,997,10984,11981
12,2023,Residenti,NASCITA,1246,12128,13374
12,2023,Residenti,RESIDENZA,4306,125649,129955
12,2023,Residenti,RESIDENZA IN CONVIVENZA,1,68,69
12,2023,Residenti,STATO CIVILE,1614,10015,11629
12,2023,Residenti,STATO FAMIGLIA,4537,50109,54646
12,2023,Residenti,STATO FAMIGLIA CON RAPPORTI PARENTELA,715,8123,8838
12,2023,Residenti,STATO FAMIGLIA E STATO CIVILE,647,6560,7207
12,2023,Residenti,STATO LIBERO,1699,3720,5419
12,2023,Residenti,UNIONE CIVILE ,8,52,60
1,2024,AIRE,CITTADINANZA,14,94,108
1,2024,AIRE,CONTESTUALE,114,549,663
1,2024,AIRE,MATRIMONIO,32,178,210
1,2024,AIRE,NASCITA,180,347,527
1,2024,AIRE,RESIDENZA,140,885,1025
1,2024,AIRE,STATO CIVILE,1,6,7
1,2024,AIRE,STATO FAMIGLIA,32,284,316
1,2024,AIRE,STATO FAMIGLIA CON RAPPORTI PARENTELA,1,3,4
1,2024,AIRE,STATO FAMIGLIA E STATO CIVILE,0,2,2
1,2024,AIRE,STATO LIBERO,1,4,5
1,2024,AIRE,UNIONE CIVILE ,0,2,2
1,2024,Residenti,CITTADINANZA,138,2731,2869
1,2024,Residenti,CONTESTUALE,11916,109124,121040
1,2024,Residenti,CONTRATTO CONVIVENZA,1,23,24
1,2024,Residenti,ESISTENZA IN VITA,211,4536,4747
1,2024,Residenti,MATRIMONIO,1366,17050,18416
1,2024,Residenti,NASCITA,1845,19413,21258
1,2024,Residenti,RESIDENZA,6059,245091,251150
1,2024,Residenti,RESIDENZA IN CONVIVENZA,0,172,172
1,2024,Residenti,STATO CIVILE,2072,16074,18146
1,2024,Residenti,STATO FAMIGLIA,7781,110284,118065
1,2024,Residenti,STATO FAMIGLIA CON RAPPORTI PARENTELA,1118,14369,15487
1,2024,Residenti,STATO FAMIGLIA E STATO CIVILE,1009,11883,12892
1,2024,Residenti,STATO LIBERO,2253,5137,7390
1,2024,Residenti,UNIONE CIVILE ,11,81,92
2,2024,AIRE,CITTADINANZA,13,138,151
2,2024,AIRE,CONTESTUALE,130,494,624
2,2024,AIRE,ESISTENZA IN VITA,0,1,1
2,2024,AIRE,MATRIMONIO,31,156,187
2,2024,AIRE,NASCITA,175,388,563
2,2024,AIRE,RESIDENZA,136,1022,1158
2,2024,AIRE,STATO CIVILE,2,9,11
2,2024,AIRE,STATO FAMIGLIA,22,292,314
2,2024,AIRE,STATO FAMIGLIA CON RAPPORTI PARENTELA,1,8,9
2,2024,AIRE,STATO FAMIGLIA E STATO CIVILE,0,4,4
2,2024,AIRE,STATO LIBERO,2,3,5
2,2024,AIRE,UNIONE CIVILE ,1,1,2
2,2024,Residenti,CITTADINANZA,121,2783,2904
2,2024,Residenti,CONTESTUALE,13354,118304,131658
2,2024,Residenti,CONTRATTO CONVIVENZA,3,20,23
2,2024,Residenti,ESISTENZA IN VITA,181,3888,4069
2,2024,Residenti,MATRIMONIO,1276,18836,20112
2,2024,Residenti,NASCITA,1756,19849,21605
2,2024,Residenti,RESIDENZA,5833,270519,276352
2,2024,Residenti,RESIDENZA IN CONVIVENZA,4,212,216
2,2024,Residenti,STATO CIVILE,2149,17123,19272
2,2024,Residenti,STATO FAMIGLIA,7070,92544,99614
2,2024,Residenti,STATO FAMIGLIA CON RAPPORTI PARENTELA,859,11620,12479
2,2024,Residenti,STATO FAMIGLIA E STATO CIVILE,1036,10536,11572
2,2024,Residenti,STATO LIBERO,2395,5529,7924
2,2024,Residenti,UNIONE CIVILE ,10,91,101
3,2024,AIRE,CITTADINANZA,9,107,116
3,2024,AIRE,CONTESTUALE,136,587,723
3,2024,AIRE,GODIMENTO DEI DIRITTI POLITICI,0,8,8
3,2024,AIRE,ISCRIZIONE NELLE LISTE ELETTORALI,2,12,14
3,2024,AIRE,MATRIMONIO,22,186,208
3,2024,AIRE,NASCITA,169,420,589
3,2024,AIRE,RESIDENZA,160,1083,1243
3,2024,AIRE,STATO CIVILE,3,10,13
3,2024,AIRE,STATO FAMIGLIA,27,288,315
3,2024,AIRE,STATO FAMIGLIA CON RAPPORTI PARENTELA,0,1,1
3,2024,AIRE,STATO FAMIGLIA E STATO CIVILE,1,5,6
3,2024,AIRE,STATO LIBERO,0,2,2
3,2024,AIRE,UNIONE CIVILE ,1,3,4
3,2024,Residenti,CITTADINANZA,163,2824,2987
3,2024,Residenti,CONTESTUALE,17096,124803,141899
3,2024,Residenti,CONTRATTO CONVIVENZA,4,16,20
3,2024,Residenti,ESISTENZA IN VITA,182,3353,3535
3,2024,Residenti,GODIMENTO DEI DIRITTI POLITICI,53,282,335
3,2024,Residenti,ISCRIZIONE NELLE LISTE ELETTORALI,15,801,816
3,2024,Residenti,MATRIMONIO,1349,18008,19357
3,2024,Residenti,NASCITA,1717,19365,21082
3,2024,Residenti,RESIDENZA,6077,268392,274469
3,2024,Residenti,RESIDENZA IN CONVIVENZA,4,223,227
3,2024,Residenti,STATO CIVILE,2131,16828,18959
3,2024,Residenti,STATO FAMIGLIA,6707,84488,91195
3,2024,Residenti,STATO FAMIGLIA CON RAPPORTI PARENTELA,859,10373,11232
3,2024,Residenti,STATO FAMIGLIA E STATO CIVILE,984,9529,10513
3,2024,Residenti,STATO LIBERO,2450,5511,7961
3,2024,Residenti,UNIONE CIVILE ,7,91,98