MESE,ANNO,TIPO SOGGETTO,TIPOLOGIA CERTIFICATO,BOLLO,ESENTI DA BOLLO,TOTALE
11,2021,AIRE,CITTADINANZA,296,191,487
11,2021,AIRE,CONTESTUALE,914,814,1728
11,2021,AIRE,ESISTENZA IN VITA,3,0,3
11,2021,AIRE,MATRIMONIO,221,270,491
11,2021,AIRE,NASCITA,448,380,828
11,2021,AIRE,RESIDENZA,648,695,1343
11,2021,AIRE,STATO CIVILE,11,4,15
11,2021,AIRE,STATO FAMIGLIA,364,410,774
11,2021,AIRE,STATO FAMIGLIA CON RAPPORTI PARENTELA,2,0,2
11,2021,AIRE,STATO FAMIGLIA E STATO CIVILE,4,2,6
11,2021,AIRE,STATO LIBERO,3,1,4
11,2021,AIRE,UNIONE CIVILE ,0,4,4
11,2021,Residenti,CITTADINANZA,4969,3810,8779
11,2021,Residenti,CONTESTUALE,52343,54320,106663
11,2021,Residenti,CONTRATTO CONVIVENZA,24,11,35
11,2021,Residenti,ESISTENZA IN VITA,4463,4939,9402
11,2021,Residenti,MATRIMONIO,14114,21301,35415
11,2021,Residenti,NASCITA,21971,29828,51799
11,2021,Residenti,RESIDENZA,40052,51691,91743
11,2021,Residenti,RESIDENZA IN CONVIVENZA,47,63,110
11,2021,Residenti,STATO CIVILE,11070,11852,22922
11,2021,Residenti,STATO FAMIGLIA,35592,48836,84428
11,2021,Residenti,STATO FAMIGLIA CON RAPPORTI PARENTELA,12197,15355,27552
11,2021,Residenti,STATO FAMIGLIA E STATO CIVILE,11151,13994,25145
11,2021,Residenti,STATO LIBERO,5464,3732,9196
11,2021,Residenti,UNIONE CIVILE ,178,158,336
12,2021,AIRE,CITTADINANZA,154,104,258
12,2021,AIRE,CONTESTUALE,449,306,755
12,2021,AIRE,ESISTENZA IN VITA,4,0,4
12,2021,AIRE,MATRIMONIO,176,140,316
12,2021,AIRE,NASCITA,307,242,549
12,2021,AIRE,RESIDENZA,424,400,824
12,2021,AIRE,STATO CIVILE,6,2,8
12,2021,AIRE,STATO FAMIGLIA,229,215,444
12,2021,AIRE,STATO FAMIGLIA CON RAPPORTI PARENTELA,0,2,2
12,2021,AIRE,STATO FAMIGLIA E STATO CIVILE,3,2,5
12,2021,AIRE,STATO LIBERO,2,0,2
12,2021,AIRE,UNIONE CIVILE ,2,3,5
12,2021,Residenti,CITTADINANZA,3231,1403,4634
12,2021,Residenti,CONTESTUALE,35861,30888,66749
12,2021,Residenti,CONTRATTO CONVIVENZA,7,6,13
12,2021,Residenti,ESISTENZA IN VITA,2617,2024,4641
12,2021,Residenti,MATRIMONIO,8807,9431,18238
12,2021,Residenti,NASCITA,12038,11044,23082
12,2021,Residenti,RESIDENZA,31679,35641,67320
12,2021,Residenti,RESIDENZA IN CONVIVENZA,37,30,67
12,2021,Residenti,STATO CIVILE,8767,7205,15972
12,2021,Residenti,STATO FAMIGLIA,29043,33571,62614
12,2021,Residenti,STATO FAMIGLIA CON RAPPORTI PARENTELA,7592,7138,14730
12,2021,Residenti,STATO FAMIGLIA E STATO CIVILE,7125,6229,13354
12,2021,Residenti,STATO LIBERO,5043,3007,8050
12,2021,Residenti,UNIONE CIVILE ,37,39,76
1,2022,AIRE,CITTADINANZA,150,88,238
1,2022,AIRE,CONTESTUALE,375,316,691
1,2022,AIRE,ESISTENZA IN VITA,0,1,1
1,2022,AIRE,MATRIMONIO,112,132,244
1,2022,AIRE,NASCITA,319,279,598
1,2022,AIRE,RESIDENZA,316,335,651
1,2022,AIRE,STATO CIVILE,6,6,12
1,2022,AIRE,STATO FAMIGLIA,188,214,402
1,2022,AIRE,STATO FAMIGLIA CON RAPPORTI PARENTELA,2,2,4
1,2022,AIRE,STATO FAMIGLIA E STATO CIVILE,1,1,2
1,2022,AIRE,STATO LIBERO,5,2,7
1,2022,AIRE,UNIONE CIVILE ,1,2,3
1,2022,Residenti,CITTADINANZA,1749,1566,3315
1,2022,Residenti,CONTESTUALE,39564,39423,78987
1,2022,Residenti,CONTRATTO CONVIVENZA,19,9,28
1,2022,Residenti,ESISTENZA IN VITA,1682,2247,3929
1,2022,Residenti,MATRIMONIO,8089,10955,19044
1,2022,Residenti,NASCITA,11234,12612,23846
1,2022,Residenti,RESIDENZA,36021,47568,83589
1,2022,Residenti,RESIDENZA IN CONVIVENZA,46,41,87
1,2022,Residenti,STATO CIVILE,8081,8845,16926
1,2022,Residenti,STATO FAMIGLIA,47609,61251,108860
1,2022,Residenti,STATO FAMIGLIA CON RAPPORTI PARENTELA,8204,10508,18712
1,2022,Residenti,STATO FAMIGLIA E STATO CIVILE,7430,8963,16393
1,2022,Residenti,STATO LIBERO,5083,3633,8716
1,2022,Residenti,UNIONE CIVILE ,35,40,75
2,2022,AIRE,CITTADINANZA,102,76,178
2,2022,AIRE,CONTESTUALE,330,330,660
2,2022,AIRE,ESISTENZA IN VITA,1,1,2
2,2022,AIRE,MATRIMONIO,104,134,238
2,2022,AIRE,NASCITA,302,248,550
2,2022,AIRE,RESIDENZA,319,339,658
2,2022,AIRE,STATO CIVILE,1,7,8
2,2022,AIRE,STATO FAMIGLIA,187,189,376
2,2022,AIRE,STATO FAMIGLIA CON RAPPORTI PARENTELA,0,5,5
2,2022,AIRE,STATO FAMIGLIA E STATO CIVILE,2,3,5
2,2022,AIRE,STATO LIBERO,0,1,1
2,2022,AIRE,UNIONE CIVILE ,4,2,6
2,2022,Residenti,CITTADINANZA,1771,1441,3212
2,2022,Residenti,CONTESTUALE,41670,40125,81795
2,2022,Residenti,CONTRATTO CONVIVENZA,11,9,20
2,2022,Residenti,ESISTENZA IN VITA,1323,1682,3005
2,2022,Residenti,MATRIMONIO,8486,11214,19700
2,2022,Residenti,NASCITA,10199,11622,21821
2,2022,Residenti,RESIDENZA,32780,42255,75035
2,2022,Residenti,RESIDENZA IN CONVIVENZA,45,41,86
2,2022,Residenti,STATO CIVILE,8716,9660,18376
2,2022,Residenti,STATO FAMIGLIA,37432,48921,86353
2,2022,Residenti,STATO FAMIGLIA CON RAPPORTI PARENTELA,6516,8468,14984
2,2022,Residenti,STATO FAMIGLIA E STATO CIVILE,6625,7881,14506
2,2022,Residenti,STATO LIBERO,5875,4484,10359
2,2022,Residenti,UNIONE CIVILE ,42,39,81
3,2022,AIRE,CITTADINANZA,98,84,182
3,2022,AIRE,CONTESTUALE,345,328,673
3,2022,AIRE,ESISTENZA IN VITA,0,1,1
3,2022,AIRE,MATRIMONIO,99,127,226
3,2022,AIRE,NASCITA,291,288,579
3,2022,AIRE,RESIDENZA,267,334,601
3,2022,AIRE,STATO CIVILE,7,13,20
3,2022,AIRE,STATO FAMIGLIA,185,205,390
3,2022,AIRE,STATO FAMIGLIA CON RAPPORTI PARENTELA,5,0,5
3,2022,AIRE,STATO FAMIGLIA E STATO CIVILE,5,4,9
3,2022,AIRE,STATO LIBERO,4,4,8
3,2022,AIRE,UNIONE CIVILE ,7,1,8
3,2022,Residenti,CITTADINANZA,2087,1405,3492
3,2022,Residenti,CONTESTUALE,46097,42836,88933
3,2022,Residenti,CONTRATTO CONVIVENZA,7,9,16
3,2022,Residenti,ESISTENZA IN VITA,1397,1508,2905
3,2022,Residenti,MATRIMONIO,9397,12218,21615
3,2022,Residenti,NASCITA,11118,12273,23391
3,2022,Residenti,RESIDENZA,37375,46412,83787
3,2022,Residenti,RESIDENZA IN CONVIVENZA,57,44,101
3,2022,Residenti,STATO CIVILE,9843,10094,19937
3,2022,Residenti,STATO FAMIGLIA,36211,46033,82244
3,2022,Residenti,STATO FAMIGLIA CON RAPPORTI PARENTELA,6490,8215,14705
3,2022,Residenti,STATO FAMIGLIA E STATO CIVILE,6726,7661,14387
3,2022,Residenti,STATO LIBERO,6607,5062,11669
3,2022,Residenti,UNIONE CIVILE ,40,48,88
4,2022,AIRE,CITTADINANZA,96,87,183
4,2022,AIRE,CONTESTUALE,346,283,629
4,2022,AIRE,ESISTENZA IN VITA,1,1,2
4,2022,AIRE,MATRIMONIO,71,120,191
4,2022,AIRE,NASCITA,273,228,501
4,2022,AIRE,RESIDENZA,341,448,789
4,2022,AIRE,STATO CIVILE,4,4,8
4,2022,AIRE,STATO FAMIGLIA,160,203,363
4,2022,AIRE,STATO FAMIGLIA CON RAPPORTI PARENTELA,0,5,5
4,2022,AIRE,STATO FAMIGLIA E STATO CIVILE,3,2,5
4,2022,AIRE,STATO LIBERO,1,4,5
4,2022,AIRE,UNIONE CIVILE ,0,2,2
4,2022,Residenti,CITTADINANZA,1640,1203,2843
4,2022,Residenti,CONTESTUALE,36735,34712,71447
4,2022,Residenti,CONTRATTO CONVIVENZA,9,4,13
4,2022,Residenti,ESISTENZA IN VITA,1049,1285,2334
4,2022,Residenti,MATRIMONIO,7535,9512,17047
4,2022,Residenti,NASCITA,9152,9970,19122
4,2022,Residenti,RESIDENZA,32040,39888,71928
4,2022,Residenti,RESIDENZA IN CONVIVENZA,47,45,92
4,2022,Residenti,STATO CIVILE,7778,8348,16126
4,2022,Residenti,STATO FAMIGLIA,27778,34665,62443
4,2022,Residenti,STATO FAMIGLIA CON RAPPORTI PARENTELA,5302,6369,11671
4,2022,Residenti,STATO FAMIGLIA E STATO CIVILE,5328,5969,11297
4,2022,Residenti,STATO LIBERO,5488,4268,9756
4,2022,Residenti,UNIONE CIVILE ,51,36,87
5,2022,AIRE,CITTADINANZA,112,86,198
5,2022,AIRE,CONTESTUALE,394,318,712
5,2022,AIRE,MATRIMONIO,116,138,254
5,2022,AIRE,NASCITA,329,242,571
5,2022,AIRE,RESIDENZA,358,416,774
5,2022,AIRE,STATO CIVILE,8,8,16
5,2022,AIRE,STATO FAMIGLIA,187,189,376
5,2022,AIRE,STATO FAMIGLIA CON RAPPORTI PARENTELA,1,5,6
5,2022,AIRE,STATO FAMIGLIA E STATO CIVILE,3,2,5
5,2022,AIRE,STATO LIBERO,4,3,7
5,2022,AIRE,UNIONE CIVILE ,0,1,1
5,2022,Residenti,CITTADINANZA,1764,1366,3130
5,2022,Residenti,CONTESTUALE,40271,38758,79029
5,2022,Residenti,CONTRATTO CONVIVENZA,19,7,26
5,2022,Residenti,ESISTENZA IN VITA,1171,1377,2548
5,2022,Residenti,MATRIMONIO,8368,11035,19403
5,2022,Residenti,NASCITA,9859,11376,21235
5,2022,Residenti,RESIDENZA,38592,46654,85246
5,2022,Residenti,RESIDENZA IN CONVIVENZA,43,51,94
5,2022,Residenti,STATO CIVILE,9318,9929,19247
5,2022,Residenti,STATO FAMIGLIA,33245,41434,74679
5,2022,Residenti,STATO FAMIGLIA CON RAPPORTI PARENTELA,5995,7388,13383
5,2022,Residenti,STATO FAMIGLIA E STATO CIVILE,6020,6934,12954
5,2022,Residenti,STATO LIBERO,6297,4987,11284
5,2022,Residenti,UNIONE CIVILE ,38,33,71
6,2022,AIRE,CITTADINANZA,123,82,205
6,2022,AIRE,CONTESTUALE,320,257,577
6,2022,AIRE,MATRIMONIO,85,100,185
6,2022,AIRE,NASCITA,283,226,509
6,2022,AIRE,RESIDENZA,291,380,671
6,2022,AIRE,STATO CIVILE,6,6,12
6,2022,AIRE,STATO FAMIGLIA,175,209,384
6,2022,AIRE,STATO FAMIGLIA CON RAPPORTI PARENTELA,2,5,7
6,2022,AIRE,STATO FAMIGLIA E STATO CIVILE,2,1,3
6,2022,AIRE,STATO LIBERO,4,2,6
6,2022,AIRE,UNIONE CIVILE ,1,0,1
6,2022,Residenti,CITTADINANZA,1798,1389,3187
6,2022,Residenti,CONTESTUALE,36962,37009,73971
6,2022,Residenti,CONTRATTO CONVIVENZA,17,6,23
6,2022,Residenti,ESISTENZA IN VITA,1081,1377,2458
6,2022,Residenti,MATRIMONIO,8431,10563,18994
6,2022,Residenti,NASCITA,9162,10055,19217
6,2022,Residenti,RESIDENZA,35239,43608,78847
6,2022,Residenti,RESIDENZA IN CONVIVENZA,39,44,83
6,2022,Residenti,STATO CIVILE,8923,9556,18479
6,2022,Residenti,STATO FAMIGLIA,30438,38064,68502
6,2022,Residenti,STATO FAMIGLIA CON RAPPORTI PARENTELA,5606,6724,12330
6,2022,Residenti,STATO FAMIGLIA E STATO CIVILE,5330,6399,11729
6,2022,Residenti,STATO LIBERO,5698,4747,10445
6,2022,Residenti,UNIONE CIVILE ,41,40,81
7,2022,AIRE,CITTADINANZA,94,76,170
7,2022,AIRE,CONTESTUALE,300,259,559
7,2022,AIRE,ESISTENZA IN VITA,2,0,2
7,2022,AIRE,MATRIMONIO,109,121,230
7,2022,AIRE,NASCITA,264,222,486
7,2022,AIRE,RESIDENZA,318,365,683
7,2022,AIRE,STATO CIVILE,6,6,12
7,2022,AIRE,STATO FAMIGLIA,182,187,369
7,2022,AIRE,STATO FAMIGLIA CON RAPPORTI PARENTELA,1,1,2
7,2022,AIRE,STATO FAMIGLIA E STATO CIVILE,1,2,3
7,2022,AIRE,STATO LIBERO,1,0,1
7,2022,AIRE,UNIONE CIVILE ,2,0,2
7,2022,Residenti,CITTADINANZA,1550,1187,2737
7,2022,Residenti,CONTESTUALE,31985,44429,76414
7,2022,Residenti,CONTRATTO CONVIVENZA,15,16,31
7,2022,Residenti,ESISTENZA IN VITA,1043,1299,2342
7,2022,Residenti,MATRIMONIO,8067,9855,17922
7,2022,Residenti,NASCITA,8589,9660,18249
7,2022,Residenti,RESIDENZA,32549,40572,73121
7,2022,Residenti,RESIDENZA IN CONVIVENZA,40,29,69
7,2022,Residenti,STATO CIVILE,7901,8464,16365
7,2022,Residenti,STATO FAMIGLIA,27215,36966,64181
7,2022,Residenti,STATO FAMIGLIA CON RAPPORTI PARENTELA,5205,6554,11759
7,2022,Residenti,STATO FAMIGLIA E STATO CIVILE,4963,5552,10515
7,2022,Residenti,STATO LIBERO,4874,4116,8990
7,2022,Residenti,UNIONE CIVILE ,52,50,102
8,2022,AIRE,CITTADINANZA,104,69,173
8,2022,AIRE,CONTESTUALE,331,271,602
8,2022,AIRE,ESISTENZA IN VITA,2,0,2
8,2022,AIRE,MATRIMONIO,87,87,174
8,2022,AIRE,NASCITA,338,270,608
8,2022,AIRE,RESIDENZA,315,363,678
8,2022,AIRE,STATO CIVILE,5,1,6
8,2022,AIRE,STATO FAMIGLIA,175,179,354
8,2022,AIRE,STATO FAMIGLIA CON RAPPORTI PARENTELA,7,4,11
8,2022,AIRE,STATO FAMIGLIA E STATO CIVILE,1,1,2
8,2022,AIRE,STATO LIBERO,2,0,2
8,2022,AIRE,UNIONE CIVILE ,0,3,3
8,2022,Residenti,CITTADINANZA,1380,1022,2402
8,2022,Residenti,CONTESTUALE,24084,35076,59160
8,2022,Residenti,CONTRATTO CONVIVENZA,13,11,24
8,2022,Residenti,ESISTENZA IN VITA,799,962,1761
8,2022,Residenti,MATRIMONIO,5386,5995,11381
8,2022,Residenti,NASCITA,7907,8471,16378
8,2022,Residenti,RESIDENZA,27577,33877,61454
8,2022,Residenti,RESIDENZA IN CONVIVENZA,25,40,65
8,2022,Residenti,STATO CIVILE,4633,5116,9749
8,2022,Residenti,STATO FAMIGLIA,21730,29610,51340
8,2022,Residenti,STATO FAMIGLIA CON RAPPORTI PARENTELA,4241,5399,9640
8,2022,Residenti,STATO FAMIGLIA E STATO CIVILE,3426,4091,7517
8,2022,Residenti,STATO LIBERO,2327,1882,4209
8,2022,Residenti,UNIONE CIVILE ,32,35,67
9,2022,AIRE,CITTADINANZA,127,62,189
9,2022,AIRE,CONTESTUALE,328,289,617
9,2022,AIRE,ESISTENZA IN VITA,3,4,7
9,2022,AIRE,MATRIMONIO,118,123,241
9,2022,AIRE,NASCITA,299,275,574
9,2022,AIRE,RESIDENZA,297,403,700
9,2022,AIRE,STATO CIVILE,10,5,15
9,2022,AIRE,STATO FAMIGLIA,187,196,383
9,2022,AIRE,STATO FAMIGLIA CON RAPPORTI PARENTELA,7,3,10
9,2022,AIRE,STATO FAMIGLIA E STATO CIVILE,3,0,3
9,2022,AIRE,STATO LIBERO,3,4,7
9,2022,Residenti,CITTADINANZA,2250,1875,4125
9,2022,Residenti,CONTESTUALE,42827,85831,128658
9,2022,Residenti,CONTRATTO CONVIVENZA,11,21,32
9,2022,Residenti,ESISTENZA IN VITA,1358,1396,2754
9,2022,Residenti,MATRIMONIO,9560,12016,21576
9,2022,Residenti,NASCITA,10998,14302,25300
9,2022,Residenti,RESIDENZA,40605,53423,94028
9,2022,Residenti,RESIDENZA IN CONVIVENZA,53,59,112
9,2022,Residenti,STATO CIVILE,9352,10141,19493
9,2022,Residenti,STATO FAMIGLIA,35160,55491,90651
9,2022,Residenti,STATO FAMIGLIA CON RAPPORTI PARENTELA,6477,8540,15017
9,2022,Residenti,STATO FAMIGLIA E STATO CIVILE,5687,6983,12670
9,2022,Residenti,STATO LIBERO,5631,4877,10508
9,2022,Residenti,UNIONE CIVILE ,46,62,108
10,2022,AIRE,CITTADINANZA,121,73,194
10,2022,AIRE,CONTESTUALE,344,317,661
10,2022,AIRE,ESISTENZA IN VITA,1,0,1
10,2022,AIRE,MATRIMONIO,111,112,223
10,2022,AIRE,NASCITA,335,268,603
10,2022,AIRE,RESIDENZA,350,386,736
10,2022,AIRE,STATO CIVILE,13,6,19
10,2022,AIRE,STATO FAMIGLIA,197,206,403
10,2022,AIRE,STATO FAMIGLIA CON RAPPORTI PARENTELA,7,5,12
10,2022,AIRE,STATO FAMIGLIA E STATO CIVILE,5,2,7
10,2022,AIRE,STATO LIBERO,6,4,10
10,2022,Residenti,CITTADINANZA,2086,1746,3832
10,2022,Residenti,CONTESTUALE,42099,68100,110199
10,2022,Residenti,CONTRATTO CONVIVENZA,14,17,31
10,2022,Residenti,ESISTENZA IN VITA,1289,1428,2717
10,2022,Residenti,MATRIMONIO,9494,11653,21147
10,2022,Residenti,NASCITA,10289,12901,23190
10,2022,Residenti,RESIDENZA,40346,52436,92782
10,2022,Residenti,RESIDENZA IN CONVIVENZA,50,50,100
10,2022,Residenti,STATO CIVILE,9048,9898,18946
10,2022,Residenti,STATO FAMIGLIA,35779,50427,86206
10,2022,Residenti,STATO FAMIGLIA CON RAPPORTI PARENTELA,6606,8438,15044
10,2022,Residenti,STATO FAMIGLIA E STATO CIVILE,6136,7373,13509
10,2022,Residenti,STATO LIBERO,5075,4549,9624
10,2022,Residenti,UNIONE CIVILE ,54,48,102
11,2022,AIRE,CITTADINANZA,145,66,211
11,2022,AIRE,CONTESTUALE,381,335,716
11,2022,AIRE,ESISTENZA IN VITA,2,1,3
11,2022,AIRE,MATRIMONIO,118,123,241
11,2022,AIRE,NASCITA,353,270,623
11,2022,AIRE,RESIDENZA,349,344,693
11,2022,AIRE,STATO CIVILE,9,2,11
11,2022,AIRE,STATO FAMIGLIA,204,197,401
11,2022,AIRE,STATO FAMIGLIA CON RAPPORTI PARENTELA,3,2,5
11,2022,AIRE,STATO FAMIGLIA E STATO CIVILE,4,5,9
11,2022,AIRE,STATO LIBERO,1,2,3
11,2022,AIRE,UNIONE CIVILE ,0,1,1
11,2022,Residenti,CITTADINANZA,2259,1692,3951
11,2022,Residenti,CONTESTUALE,40153,50161,90314
11,2022,Residenti,CONTRATTO CONVIVENZA,17,8,25
11,2022,Residenti,ESISTENZA IN VITA,1410,1599,3009
11,2022,Residenti,MATRIMONIO,8825,11591,20416
11,2022,Residenti,NASCITA,10369,11897,22266
11,2022,Residenti,RESIDENZA,39650,48722,88372
11,2022,Residenti,RESIDENZA IN CONVIVENZA,50,48,98
11,2022,Residenti,STATO CIVILE,9668,10225,19893
11,2022,Residenti,STATO FAMIGLIA,33611,45341,78952
11,2022,Residenti,STATO FAMIGLIA CON RAPPORTI PARENTELA,6875,8577,15452
11,2022,Residenti,STATO FAMIGLIA E STATO CIVILE,5979,6982,12961
11,2022,Residenti,STATO LIBERO,5499,4985,10484
11,2022,Residenti,UNIONE CIVILE ,62,37,99
12,2022,AIRE,CITTADINANZA,168,59,227
12,2022,AIRE,CONTESTUALE,432,310,742
12,2022,AIRE,ESISTENZA IN VITA,1,1,2
12,2022,AIRE,MATRIMONIO,109,112,221
12,2022,AIRE,NASCITA,323,243,566
12,2022,AIRE,RESIDENZA,441,367,808
12,2022,AIRE,STATO CIVILE,8,5,13
12,2022,AIRE,STATO FAMIGLIA,241,186,427
12,2022,AIRE,STATO FAMIGLIA CON RAPPORTI PARENTELA,4,3,7
12,2022,AIRE,STATO FAMIGLIA E STATO CIVILE,2,2,4
12,2022,AIRE,STATO LIBERO,2,1,3
12,2022,AIRE,UNIONE CIVILE ,1,0,1
12,2022,Residenti,CITTADINANZA,2678,1381,4059
12,2022,Residenti,CONTESTUALE,34636,34586,69222
12,2022,Residenti,CONTRATTO CONVIVENZA,18,9,27
12,2022,Residenti,ESISTENZA IN VITA,1954,1535,3489
12,2022,Residenti,MATRIMONIO,7293,8389,15682
12,2022,Residenti,NASCITA,9744,9086,18830
12,2022,Residenti,RESIDENZA,35119,40042,75161
12,2022,Residenti,RESIDENZA IN CONVIVENZA,44,52,96
12,2022,Residenti,STATO CIVILE,8350,7919,16269
12,2022,Residenti,STATO FAMIGLIA,29657,35102,64759
12,2022,Residenti,STATO FAMIGLIA CON RAPPORTI PARENTELA,6626,6767,13393
12,2022,Residenti,STATO FAMIGLIA E STATO CIVILE,5830,5354,11184
12,2022,Residenti,STATO LIBERO,4850,3378,8228
12,2022,Residenti,UNIONE CIVILE ,42,35,77
1,2023,AIRE,CITTADINANZA,12,187,199
1,2023,AIRE,CONTESTUALE,38,815,853
1,2023,AIRE,ESISTENZA IN VITA,0,4,4
1,2023,AIRE,MATRIMONIO,14,221,235
1,2023,AIRE,NASCITA,27,570,597
1,2023,AIRE,RESIDENZA,34,893,927
1,2023,AIRE,STATO CIVILE,0,19,19
1,2023,AIRE,STATO FAMIGLIA,21,415,436
1,2023,AIRE,STATO FAMIGLIA CON RAPPORTI PARENTELA,0,11,11
1,2023,AIRE,STATO FAMIGLIA E STATO CIVILE,0,6,6
1,2023,AIRE,STATO LIBERO,0,8,8
1,2023,AIRE,UNIONE CIVILE ,0,2,2
1,2023,Residenti,CITTADINANZA,137,3170,3307
1,2023,Residenti,CONTESTUALE,2289,90065,92354
1,2023,Residenti,CONTRATTO CONVIVENZA,0,26,26
1,2023,Residenti,ESISTENZA IN VITA,104,2996,3100
1,2023,Residenti,MATRIMONIO,408,17703,18111
1,2023,Residenti,NASCITA,713,22001,22714
1,2023,Residenti,RESIDENZA,2469,93787,96256
1,2023,Residenti,RESIDENZA IN CONVIVENZA,4,116,120
1,2023,Residenti,STATO CIVILE,441,17615,18056
1,2023,Residenti,STATO FAMIGLIA,3225,117378,120603
1,2023,Residenti,STATO FAMIGLIA CON RAPPORTI PARENTELA,463,18712,19175
1,2023,Residenti,STATO FAMIGLIA E STATO CIVILE,454,15314,15768
1,2023,Residenti,STATO LIBERO,213,7721,7934
1,2023,Residenti,UNIONE CIVILE ,2,76,78
2,2023,AIRE,CITTADINANZA,0,182,182
2,2023,AIRE,CONTESTUALE,0,725,725
2,2023,AIRE,ESISTENZA IN VITA,0,2,2
2,2023,AIRE,MATRIMONIO,0,230,230
2,2023,AIRE,NASCITA,0,591,591
2,2023,AIRE,RESIDENZA,0,751,751
2,2023,AIRE,STATO CIVILE,0,20,20
2,2023,AIRE,STATO FAMIGLIA,0,408,408
2,2023,AIRE,STATO FAMIGLIA CON RAPPORTI PARENTELA,0,9,9
2,2023,AIRE,STATO FAMIGLIA E STATO CIVILE,0,11,11
2,2023,AIRE,STATO LIBERO,0,11,11
2,2023,AIRE,UNIONE CIVILE ,0,6,6
2,2023,Residenti,CITTADINANZA,0,2963,2963
2,2023,Residenti,CONTESTUALE,0,86196,86196
2,2023,Residenti,CONTRATTO CONVIVENZA,0,18,18
2,2023,Residenti,ESISTENZA IN VITA,0,2287,2287
2,2023,Residenti,MATRIMONIO,0,18136,18136
2,2023,Residenti,NASCITA,0,19858,19858
2,2023,Residenti,RESIDENZA,0,87864,87864
2,2023,Residenti,RESIDENZA IN CONVIVENZA,0,106,106
2,2023,Residenti,STATO CIVILE,0,17801,17801
2,2023,Residenti,STATO FAMIGLIA,0,88347,88347
2,2023,Residenti,STATO FAMIGLIA CON RAPPORTI PARENTELA,0,14599,14599
2,2023,Residenti,STATO FAMIGLIA E STATO CIVILE,0,12991,12991
2,2023,Residenti,STATO LIBERO,0,8329,8329
2,2023,Residenti,UNIONE CIVILE ,0,79,79
3,2023,AIRE,CITTADINANZA,0,185,185
3,2023,AIRE,CONTESTUALE,0,749,749
3,2023,AIRE,ESISTENZA IN VITA,0,6,6
3,2023,AIRE,MATRIMONIO,0,283,283
3,2023,AIRE,NASCITA,0,554,554
3,2023,AIRE,RESIDENZA,0,891,891
3,2023,AIRE,STATO CIVILE,0,16,16
3,2023,AIRE,STATO FAMIGLIA,0,388,388
3,2023,AIRE,STATO FAMIGLIA CON RAPPORTI PARENTELA,0,14,14
3,2023,AIRE,STATO FAMIGLIA E STATO CIVILE,0,7,7
3,2023,AIRE,STATO LIBERO,0,8,8
3,2023,AIRE,UNIONE CIVILE ,0,2,2
3,2023,Residenti,CITTADINANZA,0,2957,2957
3,2023,Residenti,CONTESTUALE,0,85706,85706
3,2023,Residenti,CONTRATTO CONVIVENZA,0,23,23
3,2023,Residenti,ESISTENZA IN VITA,0,2344,2344
3,2023,Residenti,MATRIMONIO,0,17004,17004
3,2023,Residenti,NASCITA,0,19900,19900
3,2023,Residenti,RESIDENZA,0,88517,88517
3,2023,Residenti,RESIDENZA IN CONVIVENZA,0,101,101
3,2023,Residenti,STATO CIVILE,0,17275,17275
3,2023,Residenti,STATO FAMIGLIA,0,77930,77930
3,2023,Residenti,STATO FAMIGLIA CON RAPPORTI PARENTELA,0,13166,13166
3,2023,Residenti,STATO FAMIGLIA E STATO CIVILE,0,11760,11760
3,2023,Residenti,STATO LIBERO,0,7660,7660
3,2023,Residenti,UNIONE CIVILE ,0,81,81
4,2023,AIRE,CITTADINANZA,0,154,154
4,2023,AIRE,CONTESTUALE,0,622,622
4,2023,AIRE,ESISTENZA IN VITA,0,4,4
4,2023,AIRE,MATRIMONIO,0,186,186
4,2023,AIRE,NASCITA,0,433,433
4,2023,AIRE,RESIDENZA,0,694,694
4,2023,AIRE,STATO CIVILE,0,14,14
4,2023,AIRE,STATO FAMIGLIA,0,326,326
4,2023,AIRE,STATO FAMIGLIA CON RAPPORTI PARENTELA,0,4,4
4,2023,AIRE,STATO FAMIGLIA E STATO CIVILE,0,4,4
4,2023,AIRE,STATO LIBERO,0,6,6
4,2023,AIRE,UNIONE CIVILE ,0,3,3
4,2023,Residenti,CITTADINANZA,0,2347,2347
4,2023,Residenti,CONTESTUALE,0,63575,63575
4,2023,Residenti,CONTRATTO CONVIVENZA,0,13,13
4,2023,Residenti,ESISTENZA IN VITA,0,1626,1626
4,2023,Residenti,MATRIMONIO,0,11897,11897
4,2023,Residenti,NASCITA,0,14557,14557
4,2023,Residenti,RESIDENZA,0,69025,69025
4,2023,Residenti,RESIDENZA IN CONVIVENZA,0,88,88
4,2023,Residenti,STATO CIVILE,0,12478,12478
4,2023,Residenti,STATO FAMIGLIA,0,54479,54479
4,2023,Residenti,STATO FAMIGLIA CON RAPPORTI PARENTELA,0,9422,9422
4,2023,Residenti,STATO FAMIGLIA E STATO CIVILE,0,8586,8586
4,2023,Residenti,STATO LIBERO,0,5507,5507
4,2023,Residenti,UNIONE CIVILE ,0,63,63
5,2023,AIRE,CITTADINANZA,0,139,139
5,2023,AIRE,CONTESTUALE,0,611,611
5,2023,AIRE,ESISTENZA IN VITA,0,4,4
5,2023,AIRE,MATRIMONIO,0,235,235
5,2023,AIRE,NASCITA,0,439,439
5,2023,AIRE,RESIDENZA,0,782,782
5,2023,AIRE,STATO CIVILE,0,15,15
5,2023,AIRE,STATO FAMIGLIA,0,371,371
5,2023,AIRE,STATO FAMIGLIA CON RAPPORTI PARENTELA,0,7,7
5,2023,AIRE,STATO FAMIGLIA E STATO CIVILE,0,9,9
5,2023,AIRE,STATO LIBERO,0,5,5
5,2023,AIRE,UNIONE CIVILE ,0,4,4
5,2023,Residenti,CITTADINANZA,0,2759,2759
5,2023,Residenti,CONTESTUALE,0,78267,78267
5,2023,Residenti,CONTRATTO CONVIVENZA,0,14,14
5,2023,Residenti,ESISTENZA IN VITA,0,1959,1959
5,2023,Residenti,MATRIMONIO,0,16014,16014
5,2023,Residenti,NASCITA,0,17406,17406
5,2023,Residenti,RESIDENZA,0,84683,84683
5,2023,Residenti,RESIDENZA IN CONVIVENZA,0,118,118
5,2023,Residenti,STATO CIVILE,0,15933,15933
5,2023,Residenti,STATO FAMIGLIA,0,65948,65948
5,2023,Residenti,STATO FAMIGLIA CON RAPPORTI PARENTELA,0,11085,11085
5,2023,Residenti,STATO FAMIGLIA E STATO CIVILE,0,10371,10371
5,2023,Residenti,STATO LIBERO,0,6471,6471
5,2023,Residenti,UNIONE CIVILE ,0,95,95
6,2023,AIRE,CITTADINANZA,0,118,118
6,2023,AIRE,CONTESTUALE,0,575,575
6,2023,AIRE,ESISTENZA IN VITA,0,2,2
6,2023,AIRE,MATRIMONIO,0,175,175
6,2023,AIRE,NASCITA,0,442,442
6,2023,AIRE,RESIDENZA,0,746,746
6,2023,AIRE,STATO CIVILE,0,9,9
6,2023,AIRE,STATO FAMIGLIA,0,309,309
6,2023,AIRE,STATO FAMIGLIA CON RAPPORTI PARENTELA,0,2,2
6,2023,AIRE,STATO FAMIGLIA E STATO CIVILE,0,3,3
6,2023,AIRE,STATO LIBERO,0,5,5
6,2023,Residenti,CITTADINANZA,0,2485,2485
6,2023,Residenti,CONTESTUALE,0,67630,67630
6,2023,Residenti,CONTRATTO CONVIVENZA,0,11,11
6,2023,Residenti,ESISTENZA IN VITA,0,2083,2083
6,2023,Residenti,MATRIMONIO,0,14685,14685
6,2023,Residenti,NASCITA,0,15901,15901
6,2023,Residenti,RESIDENZA,0,75547,75547
6,2023,Residenti,RESIDENZA IN CONVIVENZA,0,85,85
6,2023,Residenti,STATO CIVILE,0,13708,13708
6,2023,Residenti,STATO FAMIGLIA,0,59938,59938
6,2023,Residenti,STATO FAMIGLIA CON RAPPORTI PARENTELA,0,10304,10304
6,2023,Residenti,STATO FAMIGLIA E STATO CIVILE,0,9023,9023
6,2023,Residenti,STATO LIBERO,0,5753,5753
6,2023,Residenti,UNIONE CIVILE ,0,70,70
7,2023,AIRE,CITTADINANZA,0,147,147
7,2023,AIRE,CONTESTUALE,0,594,594
7,2023,AIRE,ESISTENZA IN VITA,0,3,3
7,2023,AIRE,MATRIMONIO,0,191,191
7,2023,AIRE,NASCITA,0,459,459
7,2023,AIRE,RESIDENZA,0,637,637
7,2023,AIRE,STATO CIVILE,0,9,9
7,2023,AIRE,STATO FAMIGLIA,0,300,300
7,2023,AIRE,STATO FAMIGLIA CON RAPPORTI PARENTELA,0,4,4
7,2023,AIRE,STATO FAMIGLIA E STATO CIVILE,0,3,3
7,2023,AIRE,STATO LIBERO,0,2,2
7,2023,AIRE,UNIONE CIVILE ,0,6,6
7,2023,Residenti,CITTADINANZA,0,2205,2205
7,2023,Residenti,CONTESTUALE,0,83794,83794
7,2023,Residenti,CONTRATTO CONVIVENZA,0,16,16
7,2023,Residenti,ESISTENZA IN VITA,0,1835,1835
7,2023,Residenti,MATRIMONIO,0,14341,14341
7,2023,Residenti,NASCITA,0,16039,16039
7,2023,Residenti,RESIDENZA,0,73440,73440
7,2023,Residenti,RESIDENZA IN CONVIVENZA,0,90,90
7,2023,Residenti,STATO CIVILE,0,12771,12771
7,2023,Residenti,STATO FAMIGLIA,0,64301,64301
7,2023,Residenti,STATO FAMIGLIA CON RAPPORTI PARENTELA,0,10550,10550
7,2023,Residenti,STATO FAMIGLIA E STATO CIVILE,0,8309,8309
7,2023,Residenti,STATO LIBERO,0,5155,5155
7,2023,Residenti,UNIONE CIVILE ,0,97,97
8,2023,AIRE,CITTADINANZA,9,86,95
8,2023,AIRE,CONTESTUALE,59,372,431
8,2023,AIRE,MATRIMONIO,21,138,159
8,2023,AIRE,NASCITA,94,319,413
8,2023,AIRE,RESIDENZA,100,463,563
8,2023,AIRE,STATO CIVILE,1,7,8
8,2023,AIRE,STATO FAMIGLIA,22,202,224
8,2023,AIRE,STATO FAMIGLIA CON RAPPORTI PARENTELA,1,2,3
8,2023,AIRE,STATO FAMIGLIA E STATO CIVILE,0,1,1
8,2023,AIRE,STATO LIBERO,1,0,1
8,2023,AIRE,UNIONE CIVILE ,1,1,2
8,2023,Residenti,CITTADINANZA,69,1771,1840
8,2023,Residenti,CONTESTUALE,5211,61013,66224
8,2023,Residenti,CONTRATTO CONVIVENZA,3,13,16
8,2023,Residenti,ESISTENZA IN VITA,90,1037,1127
8,2023,Residenti,MATRIMONIO,746,7647,8393
8,2023,Residenti,NASCITA,1166,11395,12561
8,2023,Residenti,RESIDENZA,3280,52711,55991
8,2023,Residenti,RESIDENZA IN CONVIVENZA,1,57,58
8,2023,Residenti,STATO CIVILE,693,6591,7284
8,2023,Residenti,STATO FAMIGLIA,3372,43434,46806
8,2023,Residenti,STATO FAMIGLIA CON RAPPORTI PARENTELA,502,7208,7710
8,2023,Residenti,STATO FAMIGLIA E STATO CIVILE,417,5582,5999
8,2023,Residenti,STATO LIBERO,769,2108,2877
8,2023,Residenti,UNIONE CIVILE ,10,49,59
9,2023,AIRE,CITTADINANZA,11,102,113
9,2023,AIRE,CONTESTUALE,87,407,494
9,2023,AIRE,ESISTENZA IN VITA,0,1,1
9,2023,AIRE,MATRIMONIO,29,177,206
9,2023,AIRE,NASCITA,129,263,392
9,2023,AIRE,RESIDENZA,122,503,625
9,2023,AIRE,STATO CIVILE,1,5,6
9,2023,AIRE,STATO FAMIGLIA,36,235,271
9,2023,AIRE,STATO FAMIGLIA CON RAPPORTI PARENTELA,0,5,5
9,2023,AIRE,STATO FAMIGLIA E STATO CIVILE,0,5,5
9,2023,AIRE,STATO LIBERO,3,6,9
9,2023,Residenti,CITTADINANZA,104,2182,2286
9,2023,Residenti,CONTESTUALE,9131,133577,142708
9,2023,Residenti,CONTRATTO CONVIVENZA,1,9,10
9,2023,Residenti,ESISTENZA IN VITA,148,1533,1681
9,2023,Residenti,MATRIMONIO,1602,13139,14741
9,2023,Residenti,NASCITA,1653,17426,19079
9,2023,Residenti,RESIDENZA,5167,73767,78934
9,2023,Residenti,RESIDENZA IN CONVIVENZA,2,76,78
9,2023,Residenti,STATO CIVILE,2008,12161,14169
9,2023,Residenti,STATO FAMIGLIA,5683,73217,78900
9,2023,Residenti,STATO FAMIGLIA CON RAPPORTI PARENTELA,721,10996,11717
9,2023,Residenti,STATO FAMIGLIA E STATO CIVILE,789,9022,9811
9,2023,Residenti,STATO LIBERO,1925,4385,6310
9,2023,Residenti,UNIONE CIVILE ,14,76,90
10,2023,AIRE,CITTADINANZA,6,98,104
10,2023,AIRE,CONTESTUALE,107,447,554
10,2023,AIRE,ESISTENZA IN VITA,0,1,1
10,2023,AIRE,MATRIMONIO,24,175,199
10,2023,AIRE,NASCITA,95,339,434
10,2023,AIRE,RESIDENZA,123,648,771
10,2023,AIRE,STATO CIVILE,2,1,3
10,2023,AIRE,STATO FAMIGLIA,36,250,286
10,2023,AIRE,STATO FAMIGLIA CON RAPPORTI PARENTELA,0,4,4
10,2023,AIRE,STATO FAMIGLIA E STATO CIVILE,0,1,1
10,2023,AIRE,STATO LIBERO,3,0,3
10,2023,AIRE,UNIONE CIVILE ,0,1,1
10,2023,Residenti,CITTADINANZA,127,2358,2485
10,2023,Residenti,CONTESTUALE,10172,103173,113345
10,2023,Residenti,CONTRATTO CONVIVENZA,3,16,19
10,2023,Residenti,ESISTENZA IN VITA,181,1816,1997
10,2023,Residenti,MATRIMONIO,1658,14726,16384
10,2023,Residenti,NASCITA,1525,16892,18417
10,2023,Residenti,RESIDENZA,5586,76155,81741
10,2023,Residenti,RESIDENZA IN CONVIVENZA,5,95,100
10,2023,Residenti,STATO CIVILE,2150,12691,14841
10,2023,Residenti,STATO FAMIGLIA,5655,68667,74322
10,2023,Residenti,STATO FAMIGLIA CON RAPPORTI PARENTELA,774,10948,11722
10,2023,Residenti,STATO FAMIGLIA E STATO CIVILE,905,9516,10421
10,2023,Residenti,STATO LIBERO,2131,4549,6680
10,2023,Residenti,UNIONE CIVILE ,9,73,82
11,2023,AIRE,CITTADINANZA,7,105,112
11,2023,AIRE,CONTESTUALE,96,421,517
11,2023,AIRE,MATRIMONIO,19,164,183
11,2023,AIRE,NASCITA,128,294,422
11,2023,AIRE,RESIDENZA,121,582,703
11,2023,AIRE,STATO CIVILE,1,2,3
11,2023,AIRE,STATO FAMIGLIA,28,239,267
11,2023,AIRE,STATO FAMIGLIA CON RAPPORTI PARENTELA,0,3,3
11,2023,Residenti,CITTADINANZA,92,1968,2060
11,2023,Residenti,CONTESTUALE,9611,69634,79245
11,2023,Residenti,CONTRATTO CONVIVENZA,1,10,11
11,2023,Residenti,ESISTENZA IN VITA,177,1817,1994
11,2023,Residenti,MATRIMONIO,1388,13317,14705
11,2023,Residenti,NASCITA,1442,14165,15607
11,2023,Residenti,RESIDENZA,4961,70172,75133
11,2023,Residenti,RESIDENZA IN CONVIVENZA,1,66,67
11,2023,Residenti,STATO CIVILE,2106,11990,14096
11,2023,Residenti,STATO FAMIGLIA,5464,60597,66061
11,2023,Residenti,STATO FAMIGLIA CON RAPPORTI PARENTELA,771,10646,11417
11,2023,Residenti,STATO FAMIGLIA E STATO CIVILE,818,8701,9519
11,2023,Residenti,STATO LIBERO,2404,4897,7301
11,2023,Residenti,UNIONE CIVILE ,21,69,90