MESE,ANNO,TIPO SOGGETTO,TIPOLOGIA CERTIFICATO,BOLLO,ESENTI DA BOLLO,TOTALE
11,2021,AIRE,CITTADINANZA,293,191,484
11,2021,AIRE,CONTESTUALE,912,812,1724
11,2021,AIRE,ESISTENZA IN VITA,3,0,3
11,2021,AIRE,MATRIMONIO,221,269,490
11,2021,AIRE,NASCITA,448,380,828
11,2021,AIRE,RESIDENZA,644,691,1335
11,2021,AIRE,STATO CIVILE,11,4,15
11,2021,AIRE,STATO FAMIGLIA,360,410,770
11,2021,AIRE,STATO FAMIGLIA CON RAPPORTI PARENTELA,2,0,2
11,2021,AIRE,STATO FAMIGLIA E STATO CIVILE,4,2,6
11,2021,AIRE,STATO LIBERO,3,1,4
11,2021,AIRE,UNIONE CIVILE ,0,4,4
11,2021,Residenti,CITTADINANZA,4966,3808,8774
11,2021,Residenti,CONTESTUALE,52299,54278,106577
11,2021,Residenti,CONTRATTO CONVIVENZA,24,11,35
11,2021,Residenti,ESISTENZA IN VITA,4459,4937,9396
11,2021,Residenti,MATRIMONIO,14111,21293,35404
11,2021,Residenti,NASCITA,21955,29818,51773
11,2021,Residenti,RESIDENZA,40010,51636,91646
11,2021,Residenti,RESIDENZA IN CONVIVENZA,47,63,110
11,2021,Residenti,STATO CIVILE,11061,11844,22905
11,2021,Residenti,STATO FAMIGLIA,35545,48799,84344
11,2021,Residenti,STATO FAMIGLIA CON RAPPORTI PARENTELA,12187,15342,27529
11,2021,Residenti,STATO FAMIGLIA E STATO CIVILE,11145,13988,25133
11,2021,Residenti,STATO LIBERO,5460,3729,9189
11,2021,Residenti,STORICO CITTADINANZA,0,1,1
11,2021,Residenti,STORICO RESIDENZA,0,1,1
11,2021,Residenti,STORICO RESIDENZA ALLA DATA,0,2,2
11,2021,Residenti,UNIONE CIVILE ,178,158,336
12,2021,AIRE,CITTADINANZA,154,104,258
12,2021,AIRE,CONTESTUALE,445,300,745
12,2021,AIRE,ESISTENZA IN VITA,3,0,3
12,2021,AIRE,MATRIMONIO,174,137,311
12,2021,AIRE,NASCITA,303,240,543
12,2021,AIRE,RESIDENZA,423,395,818
12,2021,AIRE,STATO CIVILE,5,1,6
12,2021,AIRE,STATO FAMIGLIA,227,212,439
12,2021,AIRE,STATO FAMIGLIA CON RAPPORTI PARENTELA,0,2,2
12,2021,AIRE,STATO FAMIGLIA E STATO CIVILE,3,2,5
12,2021,AIRE,STATO LIBERO,2,0,2
12,2021,AIRE,UNIONE CIVILE ,2,3,5
12,2021,Residenti,CITTADINANZA,3231,1401,4632
12,2021,Residenti,CONTESTUALE,35827,30870,66697
12,2021,Residenti,CONTRATTO CONVIVENZA,7,6,13
12,2021,Residenti,ESISTENZA IN VITA,2617,2024,4641
12,2021,Residenti,MATRIMONIO,8804,9430,18234
12,2021,Residenti,NASCITA,12031,11037,23068
12,2021,Residenti,RESIDENZA,31650,35582,67232
12,2021,Residenti,RESIDENZA IN CONVIVENZA,37,30,67
12,2021,Residenti,STATO CIVILE,8753,7202,15955
12,2021,Residenti,STATO FAMIGLIA,29008,33557,62565
12,2021,Residenti,STATO FAMIGLIA CON RAPPORTI PARENTELA,7587,7133,14720
12,2021,Residenti,STATO FAMIGLIA E STATO CIVILE,7121,6225,13346
12,2021,Residenti,STATO LIBERO,5039,3005,8044
12,2021,Residenti,UNIONE CIVILE ,37,39,76
1,2022,AIRE,CITTADINANZA,150,88,238
1,2022,AIRE,CONTESTUALE,374,313,687
1,2022,AIRE,ESISTENZA IN VITA,0,1,1
1,2022,AIRE,MATRIMONIO,112,132,244
1,2022,AIRE,NASCITA,313,278,591
1,2022,AIRE,RESIDENZA,314,335,649
1,2022,AIRE,STATO CIVILE,3,4,7
1,2022,AIRE,STATO FAMIGLIA,187,214,401
1,2022,AIRE,STATO FAMIGLIA CON RAPPORTI PARENTELA,1,2,3
1,2022,AIRE,STATO FAMIGLIA E STATO CIVILE,1,1,2
1,2022,AIRE,STATO LIBERO,4,2,6
1,2022,AIRE,UNIONE CIVILE ,1,2,3
1,2022,Residenti,CITTADINANZA,1748,1564,3312
1,2022,Residenti,CONTESTUALE,39519,39376,78895
1,2022,Residenti,CONTRATTO CONVIVENZA,19,9,28
1,2022,Residenti,ESISTENZA IN VITA,1678,2247,3925
1,2022,Residenti,MATRIMONIO,8085,10947,19032
1,2022,Residenti,NASCITA,11225,12599,23824
1,2022,Residenti,RESIDENZA,35980,47519,83499
1,2022,Residenti,RESIDENZA IN CONVIVENZA,46,41,87
1,2022,Residenti,STATO CIVILE,8078,8840,16918
1,2022,Residenti,STATO FAMIGLIA,47558,61209,108767
1,2022,Residenti,STATO FAMIGLIA CON RAPPORTI PARENTELA,8200,10502,18702
1,2022,Residenti,STATO FAMIGLIA E STATO CIVILE,7420,8952,16372
1,2022,Residenti,STATO LIBERO,5078,3632,8710
1,2022,Residenti,UNIONE CIVILE ,35,40,75
2,2022,AIRE,CITTADINANZA,102,76,178
2,2022,AIRE,CONTESTUALE,329,324,653
2,2022,AIRE,ESISTENZA IN VITA,1,1,2
2,2022,AIRE,MATRIMONIO,102,134,236
2,2022,AIRE,NASCITA,302,246,548
2,2022,AIRE,RESIDENZA,315,337,652
2,2022,AIRE,STATO CIVILE,1,7,8
2,2022,AIRE,STATO FAMIGLIA,185,189,374
2,2022,AIRE,STATO FAMIGLIA CON RAPPORTI PARENTELA,0,5,5
2,2022,AIRE,STATO FAMIGLIA E STATO CIVILE,2,3,5
2,2022,AIRE,STATO LIBERO,0,1,1
2,2022,AIRE,UNIONE CIVILE ,4,2,6
2,2022,Residenti,CITTADINANZA,1770,1441,3211
2,2022,Residenti,CONTESTUALE,41648,40102,81750
2,2022,Residenti,CONTRATTO CONVIVENZA,11,9,20
2,2022,Residenti,ESISTENZA IN VITA,1322,1681,3003
2,2022,Residenti,MATRIMONIO,8479,11212,19691
2,2022,Residenti,NASCITA,10189,11608,21797
2,2022,Residenti,RESIDENZA,32744,42207,74951
2,2022,Residenti,RESIDENZA IN CONVIVENZA,45,41,86
2,2022,Residenti,STATO CIVILE,8713,9654,18367
2,2022,Residenti,STATO FAMIGLIA,37406,48885,86291
2,2022,Residenti,STATO FAMIGLIA CON RAPPORTI PARENTELA,6512,8464,14976
2,2022,Residenti,STATO FAMIGLIA E STATO CIVILE,6619,7877,14496
2,2022,Residenti,STATO LIBERO,5869,4484,10353
2,2022,Residenti,UNIONE CIVILE ,42,39,81
3,2022,AIRE,CITTADINANZA,98,84,182
3,2022,AIRE,CONTESTUALE,339,318,657
3,2022,AIRE,ESISTENZA IN VITA,0,1,1
3,2022,AIRE,MATRIMONIO,97,122,219
3,2022,AIRE,NASCITA,286,287,573
3,2022,AIRE,RESIDENZA,265,334,599
3,2022,AIRE,STATO CIVILE,7,13,20
3,2022,AIRE,STATO FAMIGLIA,185,205,390
3,2022,AIRE,STATO FAMIGLIA CON RAPPORTI PARENTELA,5,0,5
3,2022,AIRE,STATO FAMIGLIA E STATO CIVILE,5,4,9
3,2022,AIRE,STATO LIBERO,4,4,8
3,2022,AIRE,UNIONE CIVILE ,7,1,8
3,2022,Residenti,CITTADINANZA,2083,1403,3486
3,2022,Residenti,CONTESTUALE,46054,42814,88868
3,2022,Residenti,CONTRATTO CONVIVENZA,7,9,16
3,2022,Residenti,ESISTENZA IN VITA,1396,1508,2904
3,2022,Residenti,MATRIMONIO,9393,12214,21607
3,2022,Residenti,NASCITA,11110,12267,23377
3,2022,Residenti,RESIDENZA,37341,46385,83726
3,2022,Residenti,RESIDENZA IN CONVIVENZA,57,44,101
3,2022,Residenti,STATO CIVILE,9834,10089,19923
3,2022,Residenti,STATO FAMIGLIA,36179,46000,82179
3,2022,Residenti,STATO FAMIGLIA CON RAPPORTI PARENTELA,6486,8210,14696
3,2022,Residenti,STATO FAMIGLIA E STATO CIVILE,6722,7659,14381
3,2022,Residenti,STATO LIBERO,6601,5055,11656
3,2022,Residenti,UNIONE CIVILE ,40,48,88
4,2022,AIRE,CITTADINANZA,96,87,183
4,2022,AIRE,CONTESTUALE,343,283,626
4,2022,AIRE,ESISTENZA IN VITA,1,1,2
4,2022,AIRE,MATRIMONIO,70,120,190
4,2022,AIRE,NASCITA,267,228,495
4,2022,AIRE,RESIDENZA,337,445,782
4,2022,AIRE,STATO CIVILE,4,4,8
4,2022,AIRE,STATO FAMIGLIA,159,203,362
4,2022,AIRE,STATO FAMIGLIA CON RAPPORTI PARENTELA,0,3,3
4,2022,AIRE,STATO FAMIGLIA E STATO CIVILE,3,2,5
4,2022,AIRE,STATO LIBERO,1,4,5
4,2022,AIRE,UNIONE CIVILE ,0,2,2
4,2022,Residenti,CITTADINANZA,1639,1202,2841
4,2022,Residenti,CONTESTUALE,36703,34694,71397
4,2022,Residenti,CONTRATTO CONVIVENZA,9,4,13
4,2022,Residenti,ESISTENZA IN VITA,1049,1284,2333
4,2022,Residenti,MATRIMONIO,7529,9504,17033
4,2022,Residenti,NASCITA,9151,9967,19118
4,2022,Residenti,RESIDENZA,31999,39842,71841
4,2022,Residenti,RESIDENZA IN CONVIVENZA,47,45,92
4,2022,Residenti,STATO CIVILE,7771,8341,16112
4,2022,Residenti,STATO FAMIGLIA,27749,34635,62384
4,2022,Residenti,STATO FAMIGLIA CON RAPPORTI PARENTELA,5299,6367,11666
4,2022,Residenti,STATO FAMIGLIA E STATO CIVILE,5326,5963,11289
4,2022,Residenti,STATO LIBERO,5484,4267,9751
4,2022,Residenti,UNIONE CIVILE ,51,36,87
5,2022,AIRE,CITTADINANZA,112,86,198
5,2022,AIRE,CONTESTUALE,392,317,709
5,2022,AIRE,MATRIMONIO,114,137,251
5,2022,AIRE,NASCITA,326,239,565
5,2022,AIRE,RESIDENZA,356,415,771
5,2022,AIRE,STATO CIVILE,4,7,11
5,2022,AIRE,STATO FAMIGLIA,187,190,377
5,2022,AIRE,STATO FAMIGLIA CON RAPPORTI PARENTELA,1,5,6
5,2022,AIRE,STATO FAMIGLIA E STATO CIVILE,3,1,4
5,2022,AIRE,STATO LIBERO,3,2,5
5,2022,AIRE,UNIONE CIVILE ,0,1,1
5,2022,Residenti,CITTADINANZA,1761,1365,3126
5,2022,Residenti,CONTESTUALE,40233,38733,78966
5,2022,Residenti,CONTRATTO CONVIVENZA,19,7,26
5,2022,Residenti,ESISTENZA IN VITA,1168,1377,2545
5,2022,Residenti,MATRIMONIO,8367,11034,19401
5,2022,Residenti,NASCITA,9845,11376,21221
5,2022,Residenti,RESIDENZA,38562,46606,85168
5,2022,Residenti,RESIDENZA IN CONVIVENZA,43,51,94
5,2022,Residenti,STATO CIVILE,9311,9924,19235
5,2022,Residenti,STATO FAMIGLIA,33215,41389,74604
5,2022,Residenti,STATO FAMIGLIA CON RAPPORTI PARENTELA,5991,7385,13376
5,2022,Residenti,STATO FAMIGLIA E STATO CIVILE,6011,6934,12945
5,2022,Residenti,STATO LIBERO,6293,4985,11278
5,2022,Residenti,UNIONE CIVILE ,38,33,71
6,2022,AIRE,CITTADINANZA,123,78,201
6,2022,AIRE,CONTESTUALE,318,256,574
6,2022,AIRE,MATRIMONIO,84,95,179
6,2022,AIRE,NASCITA,279,224,503
6,2022,AIRE,RESIDENZA,290,375,665
6,2022,AIRE,STATO CIVILE,6,2,8
6,2022,AIRE,STATO FAMIGLIA,175,206,381
6,2022,AIRE,STATO FAMIGLIA CON RAPPORTI PARENTELA,1,5,6
6,2022,AIRE,STATO FAMIGLIA E STATO CIVILE,1,1,2
6,2022,AIRE,STATO LIBERO,4,2,6
6,2022,AIRE,UNIONE CIVILE ,1,0,1
6,2022,Residenti,CITTADINANZA,1798,1390,3188
6,2022,Residenti,CONTESTUALE,36938,36984,73922
6,2022,Residenti,CONTRATTO CONVIVENZA,17,6,23
6,2022,Residenti,ESISTENZA IN VITA,1081,1376,2457
6,2022,Residenti,MATRIMONIO,8430,10567,18997
6,2022,Residenti,NASCITA,9161,10054,19215
6,2022,Residenti,RESIDENZA,35198,43584,78782
6,2022,Residenti,RESIDENZA IN CONVIVENZA,39,44,83
6,2022,Residenti,STATO CIVILE,8914,9557,18471
6,2022,Residenti,STATO FAMIGLIA,30406,38034,68440
6,2022,Residenti,STATO FAMIGLIA CON RAPPORTI PARENTELA,5605,6720,12325
6,2022,Residenti,STATO FAMIGLIA E STATO CIVILE,5325,6396,11721
6,2022,Residenti,STATO LIBERO,5697,4746,10443
6,2022,Residenti,UNIONE CIVILE ,41,40,81
7,2022,AIRE,CITTADINANZA,94,75,169
7,2022,AIRE,CONTESTUALE,300,251,551
7,2022,AIRE,ESISTENZA IN VITA,2,0,2
7,2022,AIRE,MATRIMONIO,109,121,230
7,2022,AIRE,NASCITA,263,220,483
7,2022,AIRE,RESIDENZA,317,356,673
7,2022,AIRE,STATO CIVILE,5,6,11
7,2022,AIRE,STATO FAMIGLIA,182,185,367
7,2022,AIRE,STATO FAMIGLIA CON RAPPORTI PARENTELA,1,1,2
7,2022,AIRE,STATO FAMIGLIA E STATO CIVILE,1,1,2
7,2022,AIRE,STATO LIBERO,1,2,3
7,2022,AIRE,UNIONE CIVILE ,2,0,2
7,2022,Residenti,CITTADINANZA,1550,1187,2737
7,2022,Residenti,CONTESTUALE,31962,44407,76369
7,2022,Residenti,CONTRATTO CONVIVENZA,15,16,31
7,2022,Residenti,ESISTENZA IN VITA,1043,1299,2342
7,2022,Residenti,MATRIMONIO,8065,9853,17918
7,2022,Residenti,NASCITA,8588,9660,18248
7,2022,Residenti,RESIDENZA,32518,40549,73067
7,2022,Residenti,RESIDENZA IN CONVIVENZA,40,29,69
7,2022,Residenti,STATO CIVILE,7899,8462,16361
7,2022,Residenti,STATO FAMIGLIA,27184,36943,64127
7,2022,Residenti,STATO FAMIGLIA CON RAPPORTI PARENTELA,5201,6552,11753
7,2022,Residenti,STATO FAMIGLIA E STATO CIVILE,4958,5551,10509
7,2022,Residenti,STATO LIBERO,4874,4111,8985
7,2022,Residenti,UNIONE CIVILE ,52,50,102
8,2022,AIRE,CITTADINANZA,104,69,173
8,2022,AIRE,CONTESTUALE,324,267,591
8,2022,AIRE,ESISTENZA IN VITA,2,0,2
8,2022,AIRE,MATRIMONIO,87,82,169
8,2022,AIRE,NASCITA,335,265,600
8,2022,AIRE,RESIDENZA,312,353,665
8,2022,AIRE,STATO CIVILE,4,1,5
8,2022,AIRE,STATO FAMIGLIA,175,176,351
8,2022,AIRE,STATO FAMIGLIA CON RAPPORTI PARENTELA,3,3,6
8,2022,AIRE,STATO FAMIGLIA E STATO CIVILE,1,1,2
8,2022,AIRE,STATO LIBERO,2,0,2
8,2022,AIRE,UNIONE CIVILE ,0,3,3
8,2022,Residenti,CITTADINANZA,1380,1021,2401
8,2022,Residenti,CONTESTUALE,24069,35065,59134
8,2022,Residenti,CONTRATTO CONVIVENZA,13,11,24
8,2022,Residenti,ESISTENZA IN VITA,798,962,1760
8,2022,Residenti,ISCRIZIONE NELLE LISTE ELETTORALI,0,1,1
8,2022,Residenti,MATRIMONIO,5383,5997,11380
8,2022,Residenti,NASCITA,7903,8475,16378
8,2022,Residenti,RESIDENZA,27561,33858,61419
8,2022,Residenti,RESIDENZA IN CONVIVENZA,25,40,65
8,2022,Residenti,STATO CIVILE,4632,5113,9745
8,2022,Residenti,STATO FAMIGLIA,21719,29589,51308
8,2022,Residenti,STATO FAMIGLIA CON RAPPORTI PARENTELA,4243,5397,9640
8,2022,Residenti,STATO FAMIGLIA E STATO CIVILE,3425,4089,7514
8,2022,Residenti,STATO LIBERO,2323,1880,4203
8,2022,Residenti,UNIONE CIVILE ,32,35,67
9,2022,AIRE,CITTADINANZA,126,62,188
9,2022,AIRE,CONTESTUALE,320,281,601
9,2022,AIRE,ESISTENZA IN VITA,3,2,5
9,2022,AIRE,MATRIMONIO,118,122,240
9,2022,AIRE,NASCITA,296,271,567
9,2022,AIRE,RESIDENZA,293,396,689
9,2022,AIRE,STATO CIVILE,7,4,11
9,2022,AIRE,STATO FAMIGLIA,186,194,380
9,2022,AIRE,STATO FAMIGLIA CON RAPPORTI PARENTELA,6,3,9
9,2022,AIRE,STATO FAMIGLIA E STATO CIVILE,1,0,1
9,2022,AIRE,STATO LIBERO,3,3,6
9,2022,Residenti,CITTADINANZA,2249,1873,4122
9,2022,Residenti,CONTESTUALE,42800,85804,128604
9,2022,Residenti,CONTRATTO CONVIVENZA,11,21,32
9,2022,Residenti,ESISTENZA IN VITA,1357,1394,2751
9,2022,Residenti,MATRIMONIO,9558,12015,21573
9,2022,Residenti,NASCITA,10994,14297,25291
9,2022,Residenti,RESIDENZA,40566,53377,93943
9,2022,Residenti,RESIDENZA IN CONVIVENZA,53,58,111
9,2022,Residenti,STATO CIVILE,9352,10133,19485
9,2022,Residenti,STATO FAMIGLIA,35127,55456,90583
9,2022,Residenti,STATO FAMIGLIA CON RAPPORTI PARENTELA,6472,8536,15008
9,2022,Residenti,STATO FAMIGLIA E STATO CIVILE,5684,6977,12661
9,2022,Residenti,STATO LIBERO,5629,4872,10501
9,2022,Residenti,UNIONE CIVILE ,46,62,108
10,2022,AIRE,CITTADINANZA,120,73,193
10,2022,AIRE,CONTESTUALE,325,303,628
10,2022,AIRE,ESISTENZA IN VITA,1,0,1
10,2022,AIRE,MATRIMONIO,110,110,220
10,2022,AIRE,NASCITA,331,264,595
10,2022,AIRE,RESIDENZA,345,380,725
10,2022,AIRE,STATO CIVILE,11,4,15
10,2022,AIRE,STATO FAMIGLIA,197,203,400
10,2022,AIRE,STATO FAMIGLIA CON RAPPORTI PARENTELA,7,5,12
10,2022,AIRE,STATO FAMIGLIA E STATO CIVILE,5,2,7
10,2022,AIRE,STATO LIBERO,6,2,8
10,2022,Residenti,CITTADINANZA,2087,1744,3831
10,2022,Residenti,CONTESTUALE,42093,68075,110168
10,2022,Residenti,CONTRATTO CONVIVENZA,14,17,31
10,2022,Residenti,ESISTENZA IN VITA,1289,1427,2716
10,2022,Residenti,GODIMENTO DEI DIRITTI POLITICI,0,1,1
10,2022,Residenti,ISCRIZIONE NELLE LISTE ELETTORALI,0,1,1
10,2022,Residenti,MATRIMONIO,9490,11652,21142
10,2022,Residenti,NASCITA,10289,12898,23187
10,2022,Residenti,RESIDENZA,40320,52396,92716
10,2022,Residenti,RESIDENZA IN CONVIVENZA,50,50,100
10,2022,Residenti,STATO CIVILE,9044,9889,18933
10,2022,Residenti,STATO FAMIGLIA,35745,50392,86137
10,2022,Residenti,STATO FAMIGLIA CON RAPPORTI PARENTELA,6601,8438,15039
10,2022,Residenti,STATO FAMIGLIA E STATO CIVILE,6132,7370,13502
10,2022,Residenti,STATO LIBERO,5072,4547,9619
10,2022,Residenti,UNIONE CIVILE ,54,48,102
11,2022,AIRE,CITTADINANZA,145,66,211
11,2022,AIRE,CONTESTUALE,372,326,698
11,2022,AIRE,ESISTENZA IN VITA,2,1,3
11,2022,AIRE,MATRIMONIO,117,122,239
11,2022,AIRE,NASCITA,344,261,605
11,2022,AIRE,RESIDENZA,344,343,687
11,2022,AIRE,STATO CIVILE,7,1,8
11,2022,AIRE,STATO FAMIGLIA,202,196,398
11,2022,AIRE,STATO FAMIGLIA CON RAPPORTI PARENTELA,2,2,4
11,2022,AIRE,STATO FAMIGLIA E STATO CIVILE,3,1,4
11,2022,AIRE,STATO LIBERO,1,2,3
11,2022,AIRE,UNIONE CIVILE ,0,1,1
11,2022,Residenti,CITTADINANZA,2256,1691,3947
11,2022,Residenti,CONTESTUALE,40142,50144,90286
11,2022,Residenti,CONTRATTO CONVIVENZA,17,8,25
11,2022,Residenti,ESISTENZA IN VITA,1409,1598,3007
11,2022,Residenti,GODIMENTO DEI DIRITTI POLITICI,0,3,3
11,2022,Residenti,ISCRIZIONE NELLE LISTE ELETTORALI,0,1,1
11,2022,Residenti,MATRIMONIO,8823,11589,20412
11,2022,Residenti,NASCITA,10368,11905,22273
11,2022,Residenti,RESIDENZA,39638,48684,88322
11,2022,Residenti,RESIDENZA IN CONVIVENZA,50,48,98
11,2022,Residenti,STATO CIVILE,9667,10217,19884
11,2022,Residenti,STATO FAMIGLIA,33601,45309,78910
11,2022,Residenti,STATO FAMIGLIA CON RAPPORTI PARENTELA,6870,8567,15437
11,2022,Residenti,STATO FAMIGLIA E STATO CIVILE,5978,6980,12958
11,2022,Residenti,STATO LIBERO,5498,4978,10476
11,2022,Residenti,STORICO CITTADINANZA,0,1,1
11,2022,Residenti,UNIONE CIVILE ,62,37,99
12,2022,AIRE,CITTADINANZA,167,59,226
12,2022,AIRE,CONTESTUALE,422,302,724
12,2022,AIRE,ESISTENZA IN VITA,1,1,2
12,2022,AIRE,MATRIMONIO,108,111,219
12,2022,AIRE,NASCITA,316,237,553
12,2022,AIRE,RESIDENZA,435,358,793
12,2022,AIRE,STATO CIVILE,4,4,8
12,2022,AIRE,STATO FAMIGLIA,242,187,429
12,2022,AIRE,STATO FAMIGLIA CON RAPPORTI PARENTELA,4,3,7
12,2022,AIRE,STATO FAMIGLIA E STATO CIVILE,2,1,3
12,2022,AIRE,STATO LIBERO,2,1,3
12,2022,AIRE,UNIONE CIVILE ,1,0,1
12,2022,Residenti,CITTADINANZA,2676,1381,4057
12,2022,Residenti,CONTESTUALE,34624,34583,69207
12,2022,Residenti,CONTRATTO CONVIVENZA,18,9,27
12,2022,Residenti,ESISTENZA IN VITA,1954,1534,3488
12,2022,Residenti,MATRIMONIO,7294,8387,15681
12,2022,Residenti,NASCITA,9744,9085,18829
12,2022,Residenti,RESIDENZA,35087,40027,75114
12,2022,Residenti,RESIDENZA IN CONVIVENZA,44,52,96
12,2022,Residenti,STATO CIVILE,8350,7915,16265
12,2022,Residenti,STATO FAMIGLIA,29634,35070,64704
12,2022,Residenti,STATO FAMIGLIA CON RAPPORTI PARENTELA,6625,6764,13389
12,2022,Residenti,STATO FAMIGLIA E STATO CIVILE,5826,5355,11181
12,2022,Residenti,STATO LIBERO,4850,3378,8228
12,2022,Residenti,STORICO CITTADINANZA,0,1,1
12,2022,Residenti,STORICO RESIDENZA,0,1,1
12,2022,Residenti,UNIONE CIVILE ,41,35,76
1,2023,AIRE,CITTADINANZA,12,186,198
1,2023,AIRE,CONTESTUALE,38,805,843
1,2023,AIRE,ESISTENZA IN VITA,0,2,2
1,2023,AIRE,MATRIMONIO,13,213,226
1,2023,AIRE,NASCITA,27,545,572
1,2023,AIRE,RESIDENZA,34,869,903
1,2023,AIRE,STATO CIVILE,0,12,12
1,2023,AIRE,STATO FAMIGLIA,21,412,433
1,2023,AIRE,STATO FAMIGLIA CON RAPPORTI PARENTELA,0,5,5
1,2023,AIRE,STATO FAMIGLIA E STATO CIVILE,0,5,5
1,2023,AIRE,STATO LIBERO,0,9,9
1,2023,AIRE,UNIONE CIVILE ,0,2,2
1,2023,Residenti,CITTADINANZA,137,3169,3306
1,2023,Residenti,CONTESTUALE,2289,90013,92302
1,2023,Residenti,CONTRATTO CONVIVENZA,0,26,26
1,2023,Residenti,ESISTENZA IN VITA,104,2997,3101
1,2023,Residenti,MATRIMONIO,408,17706,18114
1,2023,Residenti,NASCITA,713,22008,22721
1,2023,Residenti,RESIDENZA,2468,93748,96216
1,2023,Residenti,RESIDENZA IN CONVIVENZA,4,116,120
1,2023,Residenti,STATO CIVILE,441,17616,18057
1,2023,Residenti,STATO FAMIGLIA,3223,117322,120545
1,2023,Residenti,STATO FAMIGLIA CON RAPPORTI PARENTELA,463,18696,19159
1,2023,Residenti,STATO FAMIGLIA E STATO CIVILE,454,15304,15758
1,2023,Residenti,STATO LIBERO,213,7718,7931
1,2023,Residenti,STORICO CITTADINANZA,0,1,1
1,2023,Residenti,UNIONE CIVILE ,2,76,78
2,2023,AIRE,CITTADINANZA,0,175,175
2,2023,AIRE,CONTESTUALE,0,703,703
2,2023,AIRE,ESISTENZA IN VITA,0,1,1
2,2023,AIRE,MATRIMONIO,0,220,220
2,2023,AIRE,NASCITA,0,561,561
2,2023,AIRE,RESIDENZA,0,725,725
2,2023,AIRE,STATO CIVILE,0,9,9
2,2023,AIRE,STATO FAMIGLIA,0,397,397
2,2023,AIRE,STATO FAMIGLIA CON RAPPORTI PARENTELA,0,5,5
2,2023,AIRE,STATO FAMIGLIA E STATO CIVILE,0,4,4
2,2023,AIRE,STATO LIBERO,0,5,5
2,2023,AIRE,UNIONE CIVILE ,0,6,6
2,2023,Residenti,CITTADINANZA,0,2966,2966
2,2023,Residenti,CONTESTUALE,0,86175,86175
2,2023,Residenti,CONTRATTO CONVIVENZA,0,18,18
2,2023,Residenti,ESISTENZA IN VITA,0,2287,2287
2,2023,Residenti,MATRIMONIO,0,18141,18141
2,2023,Residenti,NASCITA,0,19870,19870
2,2023,Residenti,RESIDENZA,0,87848,87848
2,2023,Residenti,RESIDENZA IN CONVIVENZA,0,104,104
2,2023,Residenti,STATO CIVILE,0,17804,17804
2,2023,Residenti,STATO FAMIGLIA,0,88328,88328
2,2023,Residenti,STATO FAMIGLIA CON RAPPORTI PARENTELA,0,14599,14599
2,2023,Residenti,STATO FAMIGLIA E STATO CIVILE,0,12985,12985
2,2023,Residenti,STATO LIBERO,0,8333,8333
2,2023,Residenti,STORICO RESIDENZA,0,1,1
2,2023,Residenti,UNIONE CIVILE ,0,79,79
3,2023,AIRE,CITTADINANZA,0,177,177
3,2023,AIRE,CONTESTUALE,0,720,720
3,2023,AIRE,MATRIMONIO,0,267,267
3,2023,AIRE,NASCITA,0,516,516
3,2023,AIRE,RESIDENZA,0,854,854
3,2023,AIRE,STATO CIVILE,0,2,2
3,2023,AIRE,STATO FAMIGLIA,0,372,372
3,2023,AIRE,STATO FAMIGLIA CON RAPPORTI PARENTELA,0,3,3
3,2023,AIRE,STATO FAMIGLIA E STATO CIVILE,0,1,1
3,2023,AIRE,STATO LIBERO,0,1,1
3,2023,AIRE,UNIONE CIVILE ,0,2,2
3,2023,Residenti,CITTADINANZA,0,2963,2963
3,2023,Residenti,CONTESTUALE,0,85677,85677
3,2023,Residenti,CONTRATTO CONVIVENZA,0,23,23
3,2023,Residenti,ESISTENZA IN VITA,0,2347,2347
3,2023,Residenti,MATRIMONIO,0,17015,17015
3,2023,Residenti,NASCITA,0,19929,19929
3,2023,Residenti,RESIDENZA,0,88527,88527
3,2023,Residenti,RESIDENZA IN CONVIVENZA,0,101,101
3,2023,Residenti,STATO CIVILE,0,17284,17284
3,2023,Residenti,STATO FAMIGLIA,0,77922,77922
3,2023,Residenti,STATO FAMIGLIA CON RAPPORTI PARENTELA,0,13166,13166
3,2023,Residenti,STATO FAMIGLIA E STATO CIVILE,0,11761,11761
3,2023,Residenti,STATO LIBERO,0,7663,7663
3,2023,Residenti,UNIONE CIVILE ,0,81,81